Date_1,Description_1,Deposits,Withdrawls,Balance
Aug,Interest,0,36393.59,36393.58
Sep,Debit Card,0,4043.73,32349.85
Oct,Purchase,2.89,0,32352.74
Nov,Bill,63,0,32415.74
Dec,Interest,76769.6,0,109185.34
Jan,Bill,94207.31,0,203392.65
Feb,Transfer,0,203392.65,0
Mar,Commission,39.73,0,39.73
Apr,Tax,89652,0,89691.73
May,Cash,0,44845.87,44845.86
Jun,NEFT,41.91,0,44887.77
Jul,Interest,0,7481.3,37406.48
Aug,ATM,0,5343.78,32062.7
Sep,Miscellaneous,3156.41,0,35219.11
Oct,Cash,6157.03,0,41376.14
Nov,Debit Card,0,6896.02,34480.12
Dec,Transfer,1266.6,0,35746.72
Jan,Purchase,208917.44,0,244664.16
Feb,ATM,23265.4,0,267929.56
Mar,NEFT,0,53585.91,214343.65
Apr,IMPS,0,21434.37,192909.28
May,Miscellaneous,0,27558.47,165350.81
Jun,Interest,0,41337.7,124013.11
Jul,Commission,282.72,0,124295.83
Aug,Tax,2,0,124297.83
Sep,Transfer,0,15537.23,108760.6
Oct,Cheque,13904.77,0,122665.37
Nov,Transfer,0,122665.37,0
Dec,Reversal,149499.8,0,149499.8
Jan,Commission,959996,0,1109495.8
Feb,Cash,0,221899.16,887596.64
Mar,Cash,0,126799.52,760797.12
Apr,Transfer,2.45,0,760799.57
May,Purchase,2,0,760801.57
Jun,Miscellaneous,0,108685.94,652115.63
Jul,Debit Card,0,65211.56,586904.07
Aug,Tax,14868.6,0,601772.67
Sep,Reversal,0,300886.34,300886.34
Oct,Debit Card,3782,0,304668.34
Nov,Bill,31820,0,336488.34
Dec,Purchase,8,0,336496.34
Jan,IMPS,193149.69,0,529646.03
Feb,ATM,0,529646.03,0
Mar,Miscellaneous,3339.42,0,3339.42
Apr,Reversal,0,477.06,2862.36
May,Reversal,240549.06,0,243411.42
Jun,Reversal,0,34773.06,208638.36
Jul,Cash,0,20863.84,187774.52
Aug,Transfer,0,23471.82,164302.7
Sep,Purchase,33.01,0,164335.71
Oct,RTGS,0,54778.57,109557.14
Nov,Transfer,0,13694.64,95862.5
Dec,Reversal,3.8,0,95866.3
Jan,Interest,0,9586.63,86279.67
Feb,Commission,0,9586.63,76693.04
Mar,Transfer,0,25564.35,51128.69
Apr,Cash,0,17042.9,34085.79
May,Commission,4563.2,0,38648.99
Jun,Cash,0,4831.12,33817.87
Jul,NEFT,0,16908.94,16908.94
Aug,NEFT,4,0,16912.94
Sep,Bill,0,1691.29,15221.65
Oct,IMPS,3258.6,0,18480.25
Nov,Miscellaneous,376,0,18856.25
Dec,Cheque,405,0,19261.25
Jan,Reversal,0,1926.13,17335.12
Feb,NEFT,0,2166.89,15168.23
Mar,Commission,0,3792.06,11376.17
Apr,Transfer,301.2,0,11677.37
May,Reversal,0,1297.49,10379.88
Jun,NEFT,12,0,10391.88
Jul,Miscellaneous,0,1484.55,8907.33
Aug,Cash,361,0,9268.33
Sep,Commission,0,1853.67,7414.66
Oct,NEFT,0,1235.78,6178.88
Nov,Transfer,602287,0,608465.88
Dec,Debit Card,6.15,0,608472.03
Jan,NEFT,0,101412.01,507060.02
Feb,RTGS,58,0,507118.02
Mar,Miscellaneous,3,0,507121.02
Apr,ATM,0,63390.13,443730.89
May,Reversal,0,443730.89,0
Jun,Transfer,1058363.2,0,1058363.2
Jul,Cash,2039653,0,3098016.2
Aug,Debit Card,0,774504.05,2323512.15
Sep,Tax,264.3,0,2323776.45
Oct,ATM,0,2323776.45,0
Nov,Debit Card,2418.59,0,2418.59
Dec,RTGS,3368,0,5786.59
Jan,Tax,208446,0,214232.59
Feb,NEFT,243.46,0,214476.05
Mar,Reversal,0,30639.44,183836.61
Apr,Purchase,0,18383.66,165452.95
May,NEFT,0,41363.24,124089.71
Jun,Reversal,416,0,124505.71
Jul,Debit Card,436646,0,561151.71
Aug,Purchase,0,280575.86,280575.86
Sep,Reversal,0,28057.59,252518.27
Oct,NEFT,0,50503.65,202014.62
Nov,RTGS,0,202014.62,0
Dec,IMPS,936277,0,936277
Jan,Cash,0,93627.7,842649.3
Feb,Debit Card,2470.4,0,845119.7
Mar,Bill,0,211279.93,633839.77
Apr,Reversal,0,211279.92,422559.85
May,Tax,0,42255.99,380303.86
Jun,Debit Card,6,0,380309.86
Jul,Interest,0,54329.98,325979.88
Aug,Tax,0,40747.49,285232.4
Sep,Reversal,753112,0,1038344.4
Oct,Cheque,0,207668.88,830675.52
Nov,RTGS,5,0,830680.52
Dec,ATM,45.5,0,830726.02
Jan,NEFT,0,118675.15,712050.87
Feb,Bill,6,0,712056.87
Mar,Cheque,0,89007.11,623049.76
Apr,Commission,3.05,0,623052.81
May,RTGS,249958,0,873010.81
Jun,Interest,0,97001.2,776009.61
Jul,Transfer,0,155201.92,620807.69
Aug,Bill,0,103467.95,517339.74
Sep,ATM,6.56,0,517346.3
Oct,Cash,0,172448.77,344897.53
Nov,Cash,0,57482.92,287414.61
Dec,RTGS,49.03,0,287463.64
Jan,RTGS,2.7,0,287466.34
Feb,Tax,0,143733.17,143733.17
Mar,Tax,0,15970.35,127762.82
Apr,IMPS,0,12776.28,114986.54
May,IMPS,0,12776.28,102210.26
Jun,Bill,0,20442.05,81768.21
Jul,Reversal,5,0,81773.21
Aug,Purchase,0,10221.65,71551.56
Sep,ATM,1517,0,73068.56
Oct,Purchase,58.32,0,73126.88
Nov,NEFT,498.1,0,73624.98
Dec,Commission,0,18406.25,55218.74
Jan,Bill,0,27609.37,27609.37
Feb,Bill,1477,0,29086.37
Mar,Commission,24177.48,0,53263.85
Apr,ATM,16117,0,69380.85
May,Cash,1.2,0,69382.05
Jun,IMPS,0,34691.03,34691.02
Jul,Interest,75165.2,0,109856.22
Aug,Reversal,0,21971.24,87884.98
Sep,Cash,31.9,0,87916.88
Oct,Miscellaneous,0,12559.55,75357.33
Nov,Reversal,0,7535.73,67821.6
Dec,Interest,0,22607.2,45214.4
Jan,Miscellaneous,0,45214.4,0
Feb,ATM,232149.8,0,232149.8
Mar,NEFT,14076,0,246225.8
Apr,Purchase,0,82075.27,164150.53
May,NEFT,53.9,0,164204.43
Jun,RTGS,2062993.25,0,2227197.68
Jul,Commission,0,371199.61,1855998.07
Aug,Commission,0,309333.01,1546665.06
Sep,Transfer,0,220952.15,1325712.91
Oct,Bill,0,220952.15,1104760.76
Nov,Cash,669526,0,1774286.76
Dec,Cheque,0,197142.97,1577143.79
Jan,Reversal,0,315428.76,1261715.03
Feb,ATM,924215,0,2185930.03
Mar,Interest,0,2185930.03,0
Apr,IMPS,21,0,21
May,Transfer,214646.3,0,214667.3
Jun,ATM,7,0,214674.3
Jul,Commission,32457.5,0,247131.8
Aug,Miscellaneous,0,30891.48,216240.32
Sep,Cash,5.69,0,216246.01
Oct,RTGS,0,72082,144164.01
Nov,Debit Card,0,48054.67,96109.34
Dec,RTGS,156073.34,0,252182.68
Jan,Bill,339.9,0,252522.58
Feb,Transfer,4.84,0,252527.42
Mar,RTGS,0,84175.81,168351.61
Apr,Reversal,0,24050.23,144301.38
May,Debit Card,14685.55,0,158986.93
Jun,Reversal,31268,0,190254.93
Jul,RTGS,0,95127.47,95127.46
Aug,Bill,22270.3,0,117397.76
Sep,Commission,17631.5,0,135029.26
Oct,NEFT,0,13502.93,121526.33
Nov,Interest,204.5,0,121730.83
Dec,Transfer,18582.6,0,140313.43
Jan,Purchase,39.1,0,140352.53
Feb,NEFT,1164.08,0,141516.61
Mar,Tax,0,47172.2,94344.41
Apr,NEFT,658.17,0,95002.58
May,Bill,0,95002.58,0
Jun,NEFT,561068,0,561068
Jul,Miscellaneous,0,112213.6,448854.4
Aug,Purchase,2468,0,451322.4
Sep,Cash,0,90264.48,361057.92
Oct,Tax,0,120352.64,240705.28
Nov,Commission,0,26745.03,213960.25
Dec,RTGS,0,23773.36,190186.89
Jan,Bill,0,190186.89,0
Feb,Reversal,56146.28,0,56146.28
Mar,Reversal,0,9357.71,46788.57
Apr,Miscellaneous,0,15596.19,31192.38
May,Reversal,1576,0,32768.38
Jun,Cash,4887.83,0,37656.21
Jul,NEFT,0,4184.02,33472.19
Aug,NEFT,0,3719.13,29753.06
Sep,IMPS,0,4250.44,25502.62
Oct,Miscellaneous,5.36,0,25507.98
Nov,Purchase,0,8502.66,17005.32
Dec,Transfer,0,8502.66,8502.66
Jan,Debit Card,0,2834.22,5668.44
Feb,Cheque,234,0,5902.44
Mar,Tax,655045,0,660947.44
Apr,Debit Card,0,132189.49,528757.95
May,Interest,0,264378.98,264378.97
Jun,Tax,49,0,264427.97
Jul,Cheque,18194,0,282621.97
Aug,Commission,96151,0,378772.97
Sep,Interest,0,42085.89,336687.08
Oct,Purchase,485.86,0,337172.94
Nov,Commission,0,67434.59,269738.35
Dec,Tax,0,89912.78,179825.57
Jan,Cheque,147,0,179972.57
Feb,Bill,57.96,0,180030.53
Mar,Cheque,0,18003.05,162027.48
Apr,RTGS,0,162027.48,0
May,Bill,2558.2,0,2558.2
Jun,Interest,2600.7,0,5158.9
Jul,Reversal,0,515.89,4643.01
Aug,Tax,0,2321.51,2321.5
Sep,Tax,0,257.94,2063.56
Oct,NEFT,0,257.95,1805.62
Nov,NEFT,0,902.81,902.81
Dec,Tax,17757,0,18659.81
Jan,Bill,0,1865.98,16793.83
Feb,ATM,0,2099.23,14694.6
Mar,Debit Card,1765,0,16459.6
Apr,Cash,9391.34,0,25850.94
May,ATM,53,0,25903.94
Jun,Commission,0,25903.94,0
Jul,Purchase,4089,0,4089
Aug,Transfer,0,584.14,3504.86
Sep,Debit Card,0,584.14,2920.72
Oct,IMPS,0,324.52,2596.2
Nov,ATM,80541,0,83137.2
Dec,Debit Card,12207.01,0,95344.21
Jan,Bill,24114.2,0,119458.41
Feb,NEFT,0,59729.21,59729.2
Mar,Debit Card,0,29864.6,29864.6
Apr,Bill,1470,0,31334.6
May,Interest,1597.3,0,32931.9
Jun,Transfer,0,4116.49,28815.41
Jul,Transfer,1415.3,0,30230.71
Aug,Tax,5.6,0,30236.31
Sep,Cheque,247908,0,278144.31
Oct,Debit Card,0,92714.77,185429.54
Nov,Tax,0,26489.93,158939.61
Dec,Tax,403,0,159342.61
Jan,ATM,0,19917.83,139424.78
Feb,NEFT,0,34856.2,104568.58
Mar,Bill,32382,0,136950.58
Apr,Interest,6.7,0,136957.28
May,Transfer,218711,0,355668.28
Jun,ATM,0,355668.28,0
Jul,Tax,17299.3,0,17299.3
Aug,Commission,13481.5,0,30780.8
Sep,RTGS,0,30780.8,0
Oct,Purchase,7.16,0,7.16
Nov,IMPS,0,1.02,6.14
Dec,RTGS,6.98,0,13.12
Jan,Cheque,63.3,0,76.42
Feb,IMPS,0,12.74,63.68
Mar,NEFT,546890,0,546953.68
Apr,Bill,243884.72,0,790838.4
May,Transfer,5037.68,0,795876.08
Jun,IMPS,260729,0,1056605.08
Jul,Reversal,0,528302.54,528302.54
Aug,Cash,0,264151.27,264151.27
Sep,Debit Card,3849,0,268000.27
Oct,Interest,3028.5,0,271028.77
Nov,Tax,0,45171.46,225857.31
Dec,ATM,1201.5,0,227058.81
Jan,ATM,57.6,0,227116.41
Feb,RTGS,0,56779.1,170337.31
Mar,Transfer,0,24333.9,146003.41
Apr,Cheque,1.2,0,146004.61
May,Cash,608444,0,754448.61
Jun,Commission,1822,0,756270.61
Jul,IMPS,0,378135.31,378135.3
Aug,Reversal,0,54019.33,324115.97
Sep,Miscellaneous,148962.9,0,473078.87
Oct,Transfer,1186.4,0,474265.27
Nov,Commission,0,59283.16,414982.11
Dec,IMPS,1660388.8,0,2075370.91
Jan,IMPS,57.4,0,2075428.31
Feb,Cash,0,1037714.16,1037714.16
Mar,Miscellaneous,31,0,1037745.16
Apr,Cheque,0,172957.53,864787.63
May,ATM,0,123541.09,741246.54
Jun,NEFT,65880,0,807126.54
Jul,Interest,0,201781.64,605344.9
Aug,Cash,494.83,0,605839.73
Sep,Bill,3536,0,609375.73
Oct,NEFT,0,67708.41,541667.32
Nov,Purchase,6,0,541673.32
Dec,Bill,180559.7,0,722233.02
Jan,Cash,220568,0,942801.02
Feb,Reversal,1107811.2,0,2050612.22
Mar,IMPS,0,512653.06,1537959.16
Apr,Bill,29.4,0,1537988.56
May,Transfer,143399.8,0,1681388.36
Jun,Commission,194.1,0,1681582.46
Jul,IMPS,0,210197.81,1471384.65
Aug,Cash,0,147138.47,1324246.18
Sep,Miscellaneous,5157,0,1329403.18
Oct,Bill,0,189914.74,1139488.44
Nov,RTGS,162.76,0,1139651.2
Dec,Bill,3.1,0,1139654.3
Jan,Reversal,144930.6,0,1284584.9
Feb,IMPS,34.63,0,1284619.53
Mar,Reversal,0,321154.88,963464.65
Apr,Commission,31.5,0,963496.15
May,Bill,0,107055.13,856441.02
Jun,Bill,0,142740.17,713700.85
Jul,NEFT,112441,0,826141.85
Aug,NEFT,187519.6,0,1013661.45
Sep,RTGS,1544042.5,0,2557703.95
Oct,Purchase,0,426283.99,2131419.96
Nov,Interest,198352.5,0,2329772.46
Dec,IMPS,223506,0,2553278.46
Jan,Bill,0,638319.62,1914958.84
Feb,Cheque,0,319159.81,1595799.03
Mar,Transfer,591.7,0,1596390.73
Apr,Commission,1111491,0,2707881.73
May,Bill,0,902627.24,1805254.49
Jun,RTGS,24937.38,0,1830191.87
Jul,Cheque,0,457547.97,1372643.9
Aug,Tax,184050.7,0,1556694.6
Sep,Cheque,22,0,1556716.6
Oct,Interest,122.2,0,1556838.8
Nov,Cash,1455.1,0,1558293.9
Dec,RTGS,0,779146.95,779146.95
Jan,Cheque,157.47,0,779304.42
Feb,NEFT,0,97413.05,681891.37
Mar,Transfer,0,85236.42,596654.95
Apr,Reversal,32420.43,0,629075.38
May,Bill,0,62907.54,566167.84
Jun,NEFT,0,188722.61,377445.23
Jul,NEFT,0,37744.52,339700.71
Aug,Cheque,40474,0,380174.71
Sep,Cheque,0,54310.67,325864.04
Oct,IMPS,9877,0,335741.04
Nov,Transfer,0,33574.1,302166.94
Dec,ATM,0,30216.69,271950.25
Jan,Transfer,0,90650.08,181300.17
Feb,Reversal,0,25900.02,155400.15
Mar,Tax,18300.27,0,173700.42
Apr,IMPS,0,43425.11,130275.32
May,Debit Card,0,65137.66,65137.66
Jun,RTGS,0,32568.83,32568.83
Jul,Reversal,0,16284.42,16284.42
Aug,ATM,30287,0,46571.42
Sep,NEFT,218795.7,0,265367.12
Oct,Commission,0,37909.59,227457.53
Nov,Transfer,0,25273.06,202184.47
Dec,RTGS,7,0,202191.47
Jan,Interest,0,25273.93,176917.54
Feb,Bill,0,17691.75,159225.79
Mar,Purchase,0,22746.54,136479.25
Apr,Bill,369,0,136848.25
May,Interest,202.47,0,137050.72
Jun,Bill,0,15227.86,121822.86
Jul,Commission,4,0,121826.86
Aug,Reversal,482.3,0,122309.16
Sep,Transfer,7.8,0,122316.96
Oct,Reversal,1510102.2,0,1632419.16
Nov,NEFT,0,816209.58,816209.58
Dec,Cash,0,272069.86,544139.72
Jan,Transfer,1914889.5,0,2459029.22
Feb,Debit Card,0,245902.92,2213126.3
Mar,Cheque,0,737708.77,1475417.53
Apr,Debit Card,0,491805.84,983611.69
May,Miscellaneous,179.6,0,983791.29
Jun,Interest,23452.9,0,1007244.19
Jul,Purchase,21964.97,0,1029209.16
Aug,Reversal,366.39,0,1029575.55
Sep,Interest,0,147082.22,882493.33
Oct,Purchase,0,882493.33,0
Nov,Commission,93929,0,93929
Dec,ATM,1980.1,0,95909.1
Jan,Transfer,24624,0,120533.1
Feb,Miscellaneous,0,17219.01,103314.09
Mar,Cheque,0,34438.03,68876.06
Apr,Purchase,1181375.75,0,1250251.81
May,Cheque,0,125025.18,1125226.63
Jun,Cheque,2.1,0,1125228.73
Jul,IMPS,0,375076.24,750152.49
Aug,Debit Card,27255.8,0,777408.29
Sep,Reversal,584944,0,1362352.29
Oct,Cash,0,340588.07,1021764.22
Nov,Commission,1794,0,1023558.22
Dec,ATM,252.6,0,1023810.82
Jan,NEFT,6.1,0,1023816.92
Feb,NEFT,397867.25,0,1421684.17
Mar,IMPS,503.33,0,1422187.5
Apr,Cash,0,237031.25,1185156.25
May,Purchase,1182.14,0,1186338.39
Jun,IMPS,0,118633.84,1067704.55
Jul,Transfer,0,133463.07,934241.48
Aug,Interest,29,0,934270.48
Sep,Reversal,0,93427.05,840843.43
Oct,Transfer,0,140140.57,700702.86
Nov,Tax,0,140140.57,560562.29
Dec,Bill,0,140140.57,420421.72
Jan,Cheque,0,105105.43,315316.29
Feb,Debit Card,27911.3,0,343227.59
Mar,ATM,0,114409.2,228818.39
Apr,Purchase,2651.66,0,231470.05
May,Tax,0,33067.15,198402.9
Jun,Cash,15068,0,213470.9
Jul,IMPS,0,71156.97,142313.93
Aug,Tax,1736261,0,1878574.93
Sep,Reversal,3.4,0,1878578.33
Oct,Bill,46.9,0,1878625.23
Nov,Cheque,81164,0,1959789.23
Dec,Cheque,2129,0,1961918.23
Jan,Interest,0,326986.37,1634931.86
Feb,Tax,0,1634931.86,0
Mar,Commission,526.5,0,526.5
Apr,Bill,0,175.5,351
May,Interest,4.1,0,355.1
Jun,Tax,118212,0,118567.1
Jul,Purchase,0,19761.18,98805.92
Aug,Debit Card,3159,0,101964.92
Sep,IMPS,1.5,0,101966.42
Oct,RTGS,30487,0,132453.42
Nov,Tax,0,66226.71,66226.71
Dec,Miscellaneous,7,0,66233.71
Jan,RTGS,4.7,0,66238.41
Feb,Cash,0,33119.21,33119.2
Mar,Miscellaneous,95695,0,128814.2
Apr,Bill,0,32203.55,96610.65
May,Transfer,0,13801.52,82809.13
Jun,Bill,0,9201.01,73608.12
Jul,Interest,1174755,0,1248363.12
Aug,NEFT,6036.36,0,1254399.48
Sep,NEFT,134223,0,1388622.48
Oct,Cash,6417.69,0,1395040.17
Nov,Interest,4,0,1395044.17
Dec,Miscellaneous,15041.7,0,1410085.87
Jan,Purchase,0,705042.94,705042.94
Feb,Debit Card,0,100720.42,604322.52
Mar,Debit Card,31514.39,0,635836.91
Apr,Cash,0,317918.46,317918.46
May,Purchase,7.04,0,317925.5
Jun,IMPS,0,105975.17,211950.33
Jul,Bill,476.95,0,212427.28
Aug,Purchase,1139951.75,0,1352379.03
Sep,Transfer,0,676189.52,676189.52
Oct,Cash,0,75132.17,601057.35
Nov,NEFT,33497.88,0,634555.23
Dec,Bill,0,79319.4,555235.83
Jan,Transfer,0,185078.61,370157.22
Feb,Cheque,0,185078.61,185078.61
Mar,Purchase,0,26439.8,158638.81
Apr,Debit Card,0,39659.7,118979.11
May,Tax,3,0,118982.11
Jun,Miscellaneous,27781.43,0,146763.54
Jul,Bill,0.81,0,146764.35
Aug,ATM,0,29352.87,117411.48
Sep,Purchase,0,13045.72,104365.76
Oct,Miscellaneous,69.3,0,104435.06
Nov,Commission,0,14919.29,89515.77
Dec,Commission,0,12787.97,76727.8
Jan,Debit Card,0,8525.31,68202.49
Feb,Tax,1557.3,0,69759.79
Mar,Debit Card,0,34879.9,34879.89
Apr,Commission,38.4,0,34918.29
May,IMPS,125529.6,0,160447.89
Jun,ATM,0,32089.58,128358.31
Jul,Reversal,4463.1,0,132821.41
Aug,Commission,0,13282.14,119539.27
Sep,Cheque,0,13282.14,106257.13
Oct,Purchase,1975.1,0,108232.23
Nov,Miscellaneous,3655.22,0,111887.45
Dec,NEFT,96.15,0,111983.6
Jan,Interest,6.9,0,111990.5
Feb,Commission,7.24,0,111997.74
Mar,RTGS,8827,0,120824.74
Apr,Tax,24.6,0,120849.34
May,Tax,0,17264.19,103585.15
Jun,Miscellaneous,13617,0,117202.15
Jul,NEFT,0,117202.15,0
Aug,Reversal,995.1,0,995.1
Sep,Purchase,0,497.55,497.55
Oct,RTGS,2,0,499.55
Nov,Purchase,4,0,503.55
Dec,Cheque,431.07,0,934.62
Jan,Cheque,457939.5,0,458874.12
Feb,RTGS,22675.8,0,481549.92
Mar,Reversal,2780.7,0,484330.62
Apr,Reversal,5.7,0,484336.32
May,Purchase,0,69190.9,415145.42
Jun,Purchase,0,59306.49,355838.93
Jul,IMPS,1468,0,357306.93
Aug,Cheque,7250.31,0,364557.24
Sep,Miscellaneous,0,91139.31,273417.93
Oct,Miscellaneous,0.59,0,273418.52
Nov,Purchase,2754.3,0,276172.82
Dec,Miscellaneous,154,0,276326.82
Jan,Miscellaneous,2.34,0,276329.16
Feb,IMPS,0,46054.86,230274.3
Mar,Cash,58,0,230332.3
Apr,Miscellaneous,0,28791.54,201540.76
May,Transfer,0,40308.15,161232.61
Jun,IMPS,0,26872.1,134360.51
Jul,Cash,0,14928.95,119431.56
Aug,Transfer,0,14928.95,104502.62
Sep,ATM,255354.5,0,359857.12
Oct,Interest,0,71971.42,287885.7
Nov,IMPS,15.8,0,287901.5
Dec,ATM,1663776,0,1951677.5
Jan,Cash,0,216853.06,1734824.44
Feb,Debit Card,0,346964.89,1387859.55
Mar,Interest,40.52,0,1387900.07
Apr,Debit Card,189,0,1388089.07
May,Miscellaneous,1.4,0,1388090.47
Jun,Purchase,0,347022.62,1041067.85
Jul,NEFT,52.37,0,1041120.22
Aug,Purchase,0,520560.11,520560.11
Sep,NEFT,0,130140.03,390420.08
Oct,Commission,0,130140.03,260280.05
Nov,NEFT,2510.6,0,262790.65
Dec,Interest,0,37541.52,225249.13
Jan,Debit Card,0,225249.13,0
Feb,Transfer,14135.2,0,14135.2
Mar,IMPS,588032,0,602167.2
Apr,Cheque,0,86023.89,516143.31
May,NEFT,7.01,0,516150.32
Jun,Debit Card,40.36,0,516190.68
Jul,Interest,0.3,0,516190.98
Aug,Purchase,0,516190.98,0
Sep,Reversal,1960828,0,1960828
Oct,Bill,31984.8,0,1992812.8
Nov,Transfer,0,332135.47,1660677.33
Dec,Cheque,1412017.75,0,3072695.08
Jan,Debit Card,23783.4,0,3096478.48
Feb,IMPS,0,387059.81,2709418.67
Mar,IMPS,0,541883.73,2167534.94
Apr,NEFT,0,433506.99,1734027.95
May,Tax,0,346805.59,1387222.36
Jun,Miscellaneous,0,198174.62,1189047.74
Jul,Cheque,0,132116.42,1056931.32
Aug,Miscellaneous,1089080,0,2146011.32
Sep,Miscellaneous,0,536502.83,1609508.49
Oct,Tax,0,201188.56,1408319.93
Nov,Cash,0,201188.56,1207131.37
Dec,ATM,463.9,0,1207595.27
Jan,Cheque,5,0,1207600.27
Feb,Cheque,1500.3,0,1209100.57
Mar,RTGS,933346,0,2142446.57
Apr,RTGS,0,214244.66,1928201.91
May,Transfer,0,385640.38,1542561.53
Jun,Bill,5264.55,0,1547826.08
Jul,RTGS,1370381,0,2918207.08
Aug,Bill,1583281,0,4501488.08
Sep,Debit Card,0,450148.81,4051339.27
Oct,Debit Card,0,1350446.42,2700892.85
Nov,RTGS,0,1350446.43,1350446.42
Dec,Tax,3525.38,0,1353971.8
Jan,Commission,3600,0,1357571.8
Feb,Debit Card,1682249.2,0,3039821
Mar,RTGS,0,379977.63,2659843.38
Apr,ATM,2306.7,0,2662150.08
May,Miscellaneous,3785.92,0,2665936
Jun,Bill,0,380848,2285088
Jul,Purchase,7,0,2285095
Aug,Reversal,0,380849.17,1904245.83
Sep,ATM,0,380849.17,1523396.66
Oct,NEFT,2678.5,0,1526075.16
Nov,RTGS,36.7,0,1526111.86
Dec,Reversal,0,763055.93,763055.93
Jan,Reversal,0,152611.19,610444.74
Feb,Debit Card,0,203481.58,406963.16
Mar,Cash,2782.6,0,409745.76
Apr,Purchase,0,102436.44,307309.32
May,Debit Card,4060.39,0,311369.71
Jun,NEFT,0,31136.97,280232.74
Jul,Reversal,1707567,0,1987799.74
Aug,Interest,309.4,0,1988109.14
Sep,Tax,180192.1,0,2168301.24
Oct,Commission,0,216830.12,1951471.12
Nov,Transfer,0,1951471.12,0
Dec,RTGS,8,0,8
Jan,Transfer,0,1.6,6.4
Feb,Interest,146,0,152.4
Mar,NEFT,35,0,187.4
Apr,ATM,0,62.47,124.93
May,NEFT,0,12.49,112.44
Jun,Bill,212192,0,212304.44
Jul,Bill,0,26538.06,185766.38
Aug,Bill,240.1,0,186006.48
Sep,IMPS,0,20667.39,165339.09
Oct,Bill,88604,0,253943.09
Nov,RTGS,0,253943.09,0
Dec,Reversal,163377.84,0,163377.84
Jan,Interest,0,20422.23,142955.61
Feb,ATM,75052.53,0,218008.14
Mar,Tax,4,0,218012.14
Apr,ATM,494.37,0,218506.51
May,Reversal,94609,0,313115.51
Jun,Commission,1.18,0,313116.69
Jul,Bill,0,31311.67,281805.02
Aug,Bill,2421,0,284226.02
Sep,Bill,0,284226.02,0
Oct,Debit Card,509.4,0,509.4
Nov,Transfer,165956,0,166465.4
Dec,Reversal,3782.2,0,170247.6
Jan,Interest,2056,0,172303.6
Feb,Interest,0,17230.36,155073.24
Mar,Cheque,3720,0,158793.24
Apr,Bill,0,52931.08,105862.16
May,RTGS,62,0,105924.16
Jun,Cash,0,11769.35,94154.81
Jul,RTGS,31,0,94185.81
Aug,IMPS,0.33,0,94186.14
Sep,Cheque,0,9418.61,84767.53
Oct,Miscellaneous,705363,0,790130.53
Nov,Cash,27.5,0,790158.03
Dec,ATM,52,0,790210.03
Jan,NEFT,0,87801.11,702408.92
Feb,NEFT,0,70240.89,632168.03
Mar,Cash,0,79021,553147.03
Apr,Purchase,70686.47,0,623833.5
May,Bill,0,69314.83,554518.67
Jun,NEFT,4047,0,558565.67
Jul,Purchase,172798.4,0,731364.07
Aug,Cheque,0,73136.41,658227.66
Sep,Debit Card,0,329113.83,329113.83
Oct,Cheque,0,47016.26,282097.57
Nov,ATM,698878,0,980975.57
Dec,Commission,3303,0,984278.57
Jan,Transfer,0,328092.86,656185.71
Feb,Interest,0,65618.57,590567.14
Mar,RTGS,560553,0,1151120.14
Apr,Debit Card,16419.7,0,1167539.84
May,Bill,0,116753.98,1050785.86
Jun,Bill,5,0,1050790.86
Jul,Bill,0,210158.17,840632.69
Aug,Bill,3326,0,843958.69
Sep,IMPS,2599.7,0,846558.39
Oct,Commission,0,169311.68,677246.71
Nov,Tax,0,96749.53,580497.18
Dec,RTGS,31,0,580528.18
Jan,ATM,0,193509.39,387018.79
Feb,Interest,6,0,387024.79
Mar,Tax,25.71,0,387050.5
Apr,Commission,437.2,0,387487.7
May,Miscellaneous,1756043.5,0,2143531.2
Jun,Reversal,4.12,0,2143535.32
Jul,Tax,7.31,0,2143542.63
Aug,RTGS,0,714514.21,1429028.42
Sep,Miscellaneous,0,357257.11,1071771.32
Oct,Commission,2.16,0,1071773.48
Nov,Bill,0,107177.35,964596.13
Dec,NEFT,0,964596.13,0
Jan,IMPS,6.3,0,6.3
Feb,Reversal,0,1.05,5.25
Mar,IMPS,0,1.75,3.5
Apr,Interest,2.81,0,6.31
May,Miscellaneous,0,0.63,5.68
Jun,Cheque,1755,0,1760.68
Jul,Commission,0,1760.68,0
Aug,IMPS,1630225.8,0,1630225.8
Sep,NEFT,24060.87,0,1654286.67
Oct,Reversal,207478.9,0,1861765.57
Nov,Commission,3,0,1861768.57
Dec,NEFT,0,265966.94,1595801.63
Jan,Bill,3468.6,0,1599270.23
Feb,IMPS,0,159927.02,1439343.21
Mar,Cheque,0,179917.9,1259425.31
Apr,Purchase,0,209904.22,1049521.09
May,Reversal,0,524760.55,524760.55
Jun,ATM,0,262380.28,262380.28
Jul,Cash,0,29153.36,233226.92
Aug,Cheque,5435,0,238661.92
Sep,Tax,0,119330.96,119330.96
Oct,Purchase,0,17047.28,102283.68
Nov,Cash,0,17047.28,85236.4
Dec,Bill,0,42618.2,42618.2
Jan,IMPS,379,0,42997.2
Feb,Cash,14,0,43011.2
Mar,Interest,0,4779.02,38232.18
Apr,Bill,2.16,0,38234.34
May,Miscellaneous,18.73,0,38253.07
Jun,Miscellaneous,0,5464.72,32788.35
Jul,Transfer,0,16394.18,16394.18
Aug,Bill,0,3278.84,13115.34
Sep,IMPS,4.13,0,13119.47
Oct,NEFT,5.05,0,13124.52
Nov,Tax,363.73,0,13488.25
Dec,Purchase,266.36,0,13754.61
Jan,Interest,25876.8,0,39631.41
Feb,Reversal,915756,0,955387.41
Mar,IMPS,1539.84,0,956927.25
Apr,Tax,2572.6,0,959499.85
May,Purchase,1463439.5,0,2422939.35
Jun,Miscellaneous,0,484587.87,1938351.48
Jul,NEFT,0,215372.39,1722979.09
Aug,Tax,3038.6,0,1726017.69
Sep,IMPS,17262.16,0,1743279.85
Oct,Cheque,302.3,0,1743582.15
Nov,Debit Card,116756.5,0,1860338.65
Dec,Cash,0,930169.33,930169.32
Jan,Transfer,1607206,0,2537375.32
Feb,Tax,466,0,2537841.32
Mar,Transfer,427407,0,2965248.32
Apr,ATM,18146.8,0,2983395.12
May,Purchase,0,426199.3,2557195.82
Jun,Purchase,0,2557195.82,0
Jul,Cash,25216.41,0,25216.41
Aug,Bill,47.54,0,25263.95
Sep,Cheque,947771.5,0,973035.45
Oct,Debit Card,281.88,0,973317.33
Nov,Cash,0,121664.67,851652.66
Dec,Purchase,0,121664.67,729987.99
Jan,Debit Card,103030.81,0,833018.8
Feb,Cash,51.95,0,833070.75
Mar,IMPS,0,833070.75,0
Apr,ATM,2.61,0,2.61
May,NEFT,0,0.33,2.28
Jun,Cheque,0,1.14,1.14
Jul,NEFT,2773,0,2774.14
Aug,ATM,0,924.71,1849.43
Sep,Cash,247.35,0,2096.78
Oct,ATM,0,419.36,1677.42
Nov,RTGS,3402.09,0,5079.51
Dec,RTGS,0,2539.76,2539.76
Jan,Cash,54.1,0,2593.86
Feb,Bill,0,370.55,2223.31
Mar,Commission,21940.8,0,24164.11
Apr,ATM,150118.6,0,174282.71
May,Tax,0,21785.34,152497.37
Jun,Purchase,13538.7,0,166036.07
Jul,RTGS,2,0,166038.07
Aug,Miscellaneous,0,27673.01,138365.06
Sep,RTGS,0,46121.69,92243.37
Oct,Cheque,0,23060.84,69182.53
Nov,NEFT,242.46,0,69424.99
Dec,Tax,0,8678.12,60746.87
Jan,Bill,0,20248.96,40497.91
Feb,RTGS,0,5062.24,35435.67
Mar,IMPS,0,4429.46,31006.21
Apr,Cash,0,7751.55,23254.66
May,Commission,370,0,23624.66
Jun,Miscellaneous,3312.9,0,26937.56
Jul,Cash,1.05,0,26938.61
Aug,Reversal,61,0,26999.61
Sep,ATM,25.4,0,27025.01
Oct,Cheque,16008,0,43033.01
Nov,IMPS,22,0,43055.01
Dec,Commission,0,10763.75,32291.26
Jan,Miscellaneous,103,0,32394.26
Feb,Debit Card,2994.4,0,35388.66
Mar,Miscellaneous,245738.4,0,281127.06
Apr,Purchase,14,0,281141.06
May,Bill,0,35142.63,245998.43
Jun,Reversal,0,245998.43,0
Jul,Miscellaneous,2032990,0,2032990
Aug,RTGS,0,203299,1829691
Sep,Tax,59,0,1829750
Oct,Interest,37967.91,0,1867717.91
Nov,Transfer,0,373543.58,1494174.33
Dec,Bill,3592.6,0,1497766.93
Jan,ATM,14.19,0,1497781.12
Feb,Purchase,0,748890.56,748890.56
Mar,Reversal,204362.5,0,953253.06
Apr,Miscellaneous,1022944,0,1976197.06
May,Cheque,0,494049.27,1482147.8
Jun,Transfer,0,370536.95,1111610.85
Jul,Transfer,0,222322.17,889288.68
Aug,Cheque,0,444644.34,444644.34
Sep,Tax,6.92,0,444651.26
Oct,Cheque,0,74108.54,370542.72
Nov,Cheque,0,185271.36,185271.36
Dec,Commission,0,26467.34,158804.02
Jan,IMPS,0,39701.01,119103.01
Feb,Purchase,0,14887.88,104215.13
Mar,RTGS,0,10421.51,93793.62
Apr,RTGS,0,18758.72,75034.9
May,Miscellaneous,0,75034.9,0
Jun,Bill,27.9,0,27.9
Jul,Commission,0,3.1,24.8
Aug,NEFT,3,0,27.8
Sep,Debit Card,5.3,0,33.1
Oct,ATM,0,11.03,22.07
Nov,IMPS,1.93,0,24
Dec,NEFT,0,8,16
Jan,Debit Card,0,4,12
Feb,Bill,0,4,8
Mar,Purchase,0,1,7
Apr,Purchase,31441.8,0,31448.8
May,Debit Card,22802.4,0,54251.2
Jun,Transfer,0,7750.17,46501.03
Jul,Tax,0,4650.1,41850.93
Aug,Purchase,0,8370.19,33480.74
Sep,Interest,0,4185.09,29295.65
Oct,Commission,0,5859.13,23436.52
Nov,Cheque,30621,0,54057.52
Dec,Cheque,0,6757.19,47300.33
Jan,RTGS,0,5255.59,42044.74
Feb,IMPS,130183.7,0,172228.44
Mar,Commission,3153.54,0,175381.98
Apr,NEFT,0,175381.98,0
May,Cash,50349,0,50349
Jun,Debit Card,5941,0,56290
Jul,NEFT,0,5629,50661
Aug,Bill,1998,0,52659
Sep,RTGS,0,5265.9,47393.1
Oct,Tax,0,23696.55,23696.55
Nov,Cash,52,0,23748.55
Dec,Miscellaneous,23.2,0,23771.75
Jan,Transfer,58.4,0,23830.15
Feb,Commission,0,4766.03,19064.12
Mar,RTGS,0,4766.03,14298.09
Apr,NEFT,238467.75,0,252765.84
May,Purchase,28667.4,0,281433.24
Jun,Miscellaneous,9440,0,290873.24
Jul,NEFT,22,0,290895.24
Aug,ATM,0,290895.24,0
Sep,Commission,55.41,0,55.41
Oct,ATM,0,9.24,46.18
Nov,Cheque,0,23.09,23.09
Dec,NEFT,0,2.57,20.52
Jan,Purchase,0,2.28,18.24
Feb,ATM,0,18.24,0
Mar,Purchase,3706.36,0,3706.36
Apr,Commission,0,370.64,3335.72
May,Cheque,15,0,3350.72
Jun,Cheque,0,1116.91,2233.81
Jul,Commission,0,446.76,1787.05
Aug,Debit Card,44,0,1831.05
Sep,Purchase,32,0,1863.05
Oct,Interest,42.92,0,1905.97
Nov,Bill,1214,0,3119.97
Dec,Transfer,0,312,2807.97
Jan,Bill,0,280.8,2527.17
Feb,Cash,0,505.43,2021.74
Mar,Interest,21549.9,0,23571.64
Apr,Purchase,4.6,0,23576.24
May,Commission,0,5894.06,17682.18
Jun,Debit Card,168847.41,0,186529.59
Jul,Miscellaneous,1170341,0,1356870.59
Aug,ATM,0,193838.66,1163031.93
Sep,NEFT,1342.54,0,1164374.47
Oct,IMPS,0,582187.24,582187.24
Nov,Transfer,16742,0,598929.24
Dec,Bill,1069,0,599998.24
Jan,Miscellaneous,0,99999.71,499998.53
Feb,ATM,47,0,500045.53
Mar,Purchase,257563.38,0,757608.91
Apr,Miscellaneous,0,151521.78,606087.13
May,ATM,0,86583.88,519503.25
Jun,IMPS,0,57722.58,461780.67
Jul,Debit Card,0,51308.96,410471.71
Aug,Purchase,86484,0,496955.71
Sep,Bill,9309.1,0,506264.81
Oct,Cheque,3948.6,0,510213.41
Nov,Cash,236689,0,746902.41
Dec,ATM,0,373451.21,373451.2
Jan,Miscellaneous,223208.31,0,596659.51
Feb,Cheque,5228.2,0,601887.71
Mar,Reversal,31779.4,0,633667.11
Apr,Reversal,61605,0,695272.11
May,Miscellaneous,63,0,695335.11
Jun,Transfer,0,115889.19,579445.93
Jul,Miscellaneous,1556167,0,2135612.93
Aug,Transfer,0,237290.33,1898322.6
Sep,Transfer,0,189832.26,1708490.34
Oct,Bill,0,170849.03,1537641.31
Nov,ATM,0,768820.66,768820.66
Dec,IMPS,345.9,0,769166.56
Jan,NEFT,0,153833.31,615333.25
Feb,Bill,3584,0,618917.25
Mar,Commission,3739.74,0,622656.99
Apr,Reversal,22.51,0,622679.5
May,Cash,0,124535.9,498143.6
Jun,Transfer,25.7,0,498169.3
Jul,NEFT,0,249084.65,249084.65
Aug,Miscellaneous,157494,0,406578.65
Sep,Transfer,0,67763.11,338815.54
Oct,Tax,0,84703.89,254111.65
Nov,Commission,3763.35,0,257875
Dec,IMPS,83559,0,341434
Jan,NEFT,0,37937.11,303496.89
Feb,Interest,0,33721.88,269775.01
Mar,Tax,0,29975,239800.01
Apr,Transfer,0,79933.34,159866.67
May,Cheque,0,22838.1,137028.57
Jun,NEFT,0,68514.29,68514.28
Jul,Transfer,0,17128.57,51385.71
Aug,Cash,0,5709.52,45676.19
Sep,Transfer,8,0,45684.19
Oct,Bill,61.4,0,45745.59
Nov,Transfer,1435,0,47180.59
Dec,Transfer,249607.97,0,296788.56
Jan,RTGS,5.8,0,296794.36
Feb,Commission,63,0,296857.36
Mar,Commission,3508,0,300365.36
Apr,Cheque,0,60073.07,240292.29
May,IMPS,2028144.5,0,2268436.79
Jun,RTGS,0,324062.4,1944374.39
Jul,Cash,0,972187.2,972187.2
Aug,Interest,0,162031.2,810156
Sep,RTGS,190153.44,0,1000309.44
Oct,Commission,0,333436.48,666872.96
Nov,Interest,0,95267.57,571605.39
Dec,Commission,0,190535.13,381070.26
Jan,Debit Card,7047,0,388117.26
Feb,Purchase,3810.47,0,391927.73
Mar,Transfer,0,39192.77,352734.96
Apr,Debit Card,0,39192.77,313542.19
May,Bill,3.91,0,313546.1
Jun,Cheque,0,39193.26,274352.84
Jul,Commission,0,30483.65,243869.19
Aug,ATM,186448,0,430317.19
Sep,Bill,0,107579.3,322737.89
Oct,NEFT,666452,0,989189.89
Nov,NEFT,314,0,989503.89
Dec,RTGS,0,329834.63,659669.26
Jan,Interest,20007.9,0,679677.16
Feb,Interest,14274,0,693951.16
Mar,Transfer,0,231317.05,462634.11
Apr,Debit Card,1580996.8,0,2043630.91
May,Debit Card,1,0,2043631.91
Jun,Cash,851002,0,2894633.91
Jul,Miscellaneous,156.66,0,2894790.57
Aug,IMPS,0,289479.06,2605311.51
Sep,Commission,5,0,2605316.51
Oct,Transfer,0,372188.07,2233128.44
Nov,Interest,817783,0,3050911.44
Dec,Reversal,215,0,3051126.44
Jan,IMPS,0,435875.21,2615251.23
Feb,Commission,0,2615251.23,0
Mar,Cheque,29.3,0,29.3
Apr,RTGS,231436,0,231465.3
May,ATM,219043.5,0,450508.8
Jun,Bill,0,50056.53,400452.27
Jul,Purchase,0,80090.45,320361.82
Aug,Bill,1095,0,321456.82
Sep,NEFT,0,80364.21,241092.62
Oct,Interest,0,48218.52,192874.1
Nov,Reversal,192383,0,385257.1
Dec,Commission,7,0,385264.1
Jan,Cash,1.5,0,385265.6
Feb,NEFT,25337.64,0,410603.24
Mar,Cash,176460.4,0,587063.64
Apr,Debit Card,0,293531.82,293531.82
May,Transfer,0,32614.65,260917.17
Jun,Bill,0,26091.72,234825.45
Jul,Interest,114286,0,349111.45
Aug,Interest,28733,0,377844.45
Sep,NEFT,26,0,377870.45
Oct,Cheque,255.5,0,378125.95
Nov,NEFT,0,54017.99,324107.96
Dec,NEFT,0,46301.14,277806.82
Jan,Transfer,0,27780.68,250026.14
Feb,Debit Card,0,83342.05,166684.09
Mar,RTGS,4.69,0,166688.78
Apr,Bill,0.7,0,166689.48
May,Commission,5763.6,0,172453.08
Jun,IMPS,1062.1,0,173515.18
Jul,Bill,193615,0,367130.18
Aug,Debit Card,35,0,367165.18
Sep,Reversal,0,40796.13,326369.05
Oct,IMPS,8.9,0,326377.95
Nov,Cheque,0,40797.24,285580.71
Dec,IMPS,2023,0,287603.71
Jan,NEFT,614652,0,902255.71
Feb,Tax,18539.43,0,920795.14
Mar,Miscellaneous,477.5,0,921272.64
Apr,ATM,809.95,0,922082.59
May,Purchase,0,115260.32,806822.27
Jun,NEFT,3279.06,0,810101.33
Jul,Tax,0,270033.78,540067.55
Aug,Reversal,8988,0,549055.55
Sep,NEFT,12542.3,0,561597.85
Oct,Reversal,0,280798.93,280798.92
Nov,ATM,259847.4,0,540646.32
Dec,Transfer,0,270323.16,270323.16
Jan,NEFT,0,90107.72,180215.44
Feb,RTGS,39.7,0,180255.14
Mar,Reversal,231721,0,411976.14
Apr,Cash,322.19,0,412298.33
May,Purchase,43.2,0,412341.53
Jun,Transfer,7.31,0,412348.84
Jul,RTGS,543729,0,956077.84
Aug,RTGS,0,318692.61,637385.23
Sep,IMPS,0,127477.05,509908.18
Oct,Tax,0,169969.39,339938.79
Nov,NEFT,3862.1,0,343800.89
Dec,Bill,0,343800.89,0
Jan,Debit Card,21344.96,0,21344.96
Feb,RTGS,0,3049.28,18295.68
Mar,Cheque,0,2286.96,16008.72
Apr,Interest,0,2668.12,13340.6
May,Purchase,48367,0,61707.6
Jun,Interest,1109200.25,0,1170907.85
Jul,Transfer,0,130100.87,1040806.98
Aug,Cheque,0,520403.49,520403.49
Sep,IMPS,0,520403.49,0
Oct,Interest,2,0,2
Nov,Tax,104156,0,104158
Dec,ATM,3.7,0,104161.7
Jan,Interest,0,10416.17,93745.53
Feb,Miscellaneous,1345206.2,0,1438951.73
Mar,Debit Card,1,0,1438952.73
Apr,Miscellaneous,0,159883.64,1279069.09
May,Commission,422.68,0,1279491.77
Jun,Interest,2872.8,0,1282364.57
Jul,Cheque,1265171,0,2547535.57
Aug,RTGS,0,509507.11,2038028.46
Sep,Cheque,651428.5,0,2689456.96
Oct,Interest,0,268945.7,2420511.26
Nov,IMPS,27888,0,2448399.26
Dec,IMPS,2166.1,0,2450565.36
Jan,Debit Card,7688,0,2458253.36
Feb,Cash,0,2458253.36,0
Mar,Cash,56,0,56
Apr,RTGS,1489.02,0,1545.02
May,Transfer,549,0,2094.02
Jun,Interest,7.45,0,2101.47
Jul,Debit Card,63.6,0,2165.07
Aug,Miscellaneous,0,433.01,1732.06
Sep,Purchase,0,216.51,1515.55
Oct,ATM,0,303.11,1212.44
Nov,Transfer,1023.88,0,2236.32
Dec,IMPS,0,745.44,1490.88
Jan,ATM,33.4,0,1524.28
Feb,Miscellaneous,0,1524.28,0
Mar,Tax,97169,0,97169
Apr,Cash,125941,0,223110
May,NEFT,50.73,0,223160.73
Jun,Tax,37.6,0,223198.33
Jul,Purchase,141.35,0,223339.68
Aug,Cash,0,37223.28,186116.4
Sep,Purchase,53.09,0,186169.49
Oct,Purchase,0,23271.19,162898.3
Nov,Cheque,0,54299.43,108598.87
Dec,Commission,27.85,0,108626.72
Jan,Commission,2.1,0,108628.82
Feb,Purchase,1,0,108629.82
Mar,Interest,16.6,0,108646.42
Apr,Cash,0,13580.8,95065.62
May,ATM,5,0,95070.62
Jun,Transfer,386,0,95456.62
Jul,Miscellaneous,0,11932.08,83524.54
Aug,IMPS,0,13920.76,69603.78
Sep,Transfer,15677.37,0,85281.15
Oct,Transfer,4095.42,0,89376.57
Nov,Commission,463777,0,553153.57
Dec,Debit Card,2788.07,0,555941.64
Jan,Tax,0,61771.29,494170.35
Feb,Transfer,0,70595.76,423574.59
Mar,Commission,0,47063.84,376510.75
Apr,RTGS,0,125503.58,251007.17
May,Reversal,0,83669.06,167338.11
Jun,IMPS,0,27889.69,139448.42
Jul,Cheque,46,0,139494.42
Aug,Interest,0,27898.88,111595.54
Sep,Purchase,0,18599.26,92996.28
Oct,Purchase,0,23249.07,69747.21
Nov,Reversal,0,23249.07,46498.14
Dec,Debit Card,0,11624.54,34873.6
Jan,Tax,1.73,0,34875.33
Feb,Cheque,761251.2,0,796126.53
Mar,Debit Card,0,99515.82,696610.71
Apr,Bill,0,232203.57,464407.14
May,Interest,59.59,0,464466.73
Jun,Interest,7.1,0,464473.83
Jul,ATM,0,116118.46,348355.37
Aug,ATM,0,49765.05,298590.32
Sep,Cheque,14822,0,313412.32
Oct,Cheque,0.69,0,313413.01
Nov,Miscellaneous,5.67,0,313418.68
Dec,Cash,0,34824.3,278594.38
Jan,RTGS,6.7,0,278601.08
Feb,Cheque,3108.15,0,281709.23
Mar,Cash,0,140854.62,140854.62
Apr,Transfer,0,28170.92,112683.7
May,Interest,0,56341.85,56341.85
Jun,RTGS,0,7042.73,49299.12
Jul,Cash,12911.1,0,62210.22
Aug,Cheque,3979.12,0,66189.34
Sep,Cheque,0,16547.34,49642
Oct,NEFT,291,0,49933
Nov,Cheque,0,4993.3,44939.7
Dec,Transfer,0,22469.85,22469.85
Jan,Interest,6.48,0,22476.33
Feb,RTGS,43,0,22519.33
Mar,Cheque,0,3753.22,18766.11
Apr,Bill,6,0,18772.11
May,IMPS,0,18772.11,0
Jun,IMPS,1.59,0,1.59
Jul,NEFT,2.8,0,4.39
Aug,Miscellaneous,0,0.88,3.51
Sep,Cash,300635.5,0,300639.01
Oct,Commission,0,75159.75,225479.26
Nov,Cash,0,56369.82,169109.44
Dec,Purchase,2.7,0,169112.14
Jan,Cheque,18239.35,0,187351.49
Feb,IMPS,0,23418.94,163932.55
Mar,NEFT,229424,0,393356.55
Apr,Miscellaneous,187.2,0,393543.75
May,NEFT,0,196771.88,196771.88
Jun,Debit Card,230.65,0,197002.53
Jul,IMPS,0,24625.32,172377.21
Aug,Cash,0,34475.44,137901.77
Sep,RTGS,3.1,0,137904.87
Oct,Interest,0,17238.11,120666.76
Nov,RTGS,0,120666.76,0
Dec,Debit Card,222,0,222
Jan,Debit Card,648,0,870
Feb,Bill,379,0,1249
Mar,Transfer,0,624.5,624.5
Apr,Cheque,0,62.45,562.05
May,Transfer,116288.31,0,116850.36
Jun,IMPS,0,16692.91,100157.45
Jul,Bill,0,50078.73,50078.72
Aug,Debit Card,0,5564.3,44514.42
Sep,Transfer,2.19,0,44516.61
Oct,Purchase,2062.1,0,46578.71
Nov,Tax,0,11644.68,34934.03
Dec,Commission,0,3881.56,31052.47
Jan,IMPS,217371.06,0,248423.53
Feb,Cheque,0,49684.71,198738.82
Mar,Interest,0,28391.26,170347.56
Apr,Tax,39.8,0,170387.36
May,ATM,20638.8,0,191026.16
Jun,Purchase,0,95513.08,95513.08
Jul,Transfer,153287.62,0,248800.7
Aug,Reversal,16346,0,265146.7
Sep,NEFT,7,0,265153.7
Oct,Transfer,0,88384.57,176769.13
Nov,Transfer,702728,0,879497.13
Dec,Tax,0,293165.71,586331.42
Jan,NEFT,141385.5,0,727716.92
Feb,IMPS,0,72771.69,654945.23
Mar,Reversal,0,65494.52,589450.71
Apr,Miscellaneous,13852.61,0,603303.32
May,Debit Card,0,201101.11,402202.21
Jun,Interest,200.34,0,402402.55
Jul,Miscellaneous,0,402402.55,0
Aug,Purchase,3792.24,0,3792.24
Sep,Miscellaneous,418.5,0,4210.74
Oct,Debit Card,0,526.34,3684.4
Nov,NEFT,0,1842.2,1842.2
Dec,Miscellaneous,15529.7,0,17371.9
Jan,ATM,0,2171.49,15200.41
Feb,Miscellaneous,0,2171.49,13028.92
Mar,ATM,0,6514.46,6514.46
Apr,Interest,472.5,0,6986.96
May,IMPS,2.9,0,6989.86
Jun,ATM,0,776.65,6213.21
Jul,Interest,1791839,0,1798052.21
Aug,Transfer,0,224756.53,1573295.68
Sep,NEFT,1111344,0,2684639.68
Oct,RTGS,0,335579.96,2349059.72
Nov,Miscellaneous,1607658,0,3956717.72
Dec,Miscellaneous,4.1,0,3956721.82
Jan,Interest,0,791344.36,3165377.46
Feb,Cheque,0,395672.18,2769705.28
Mar,Tax,0,1384852.64,1384852.64
Apr,Cash,0,230808.77,1154043.87
May,Debit Card,0,128227.1,1025816.77
Jun,Bill,0,102581.68,923235.09
Jul,ATM,0,115404.39,807830.7
Aug,NEFT,17201,0,825031.7
Sep,Tax,63.7,0,825095.4
Oct,Bill,1110.78,0,826206.18
Nov,Debit Card,0,206551.55,619654.64
Dec,Miscellaneous,0,154913.66,464740.98
Jan,Cheque,0,92948.2,371792.78
Feb,Commission,136194.5,0,507987.28
Mar,Purchase,0.1,0,507987.38
Apr,Miscellaneous,3992.8,0,511980.18
May,Miscellaneous,9810.9,0,521791.08
Jun,Reversal,822583.25,0,1344374.33
Jul,Cheque,7.4,0,1344381.73
Aug,Cash,0,672190.87,672190.86
Sep,Cash,4091,0,676281.86
Oct,Interest,0,225427.29,450854.57
Nov,Tax,0,64407.8,386446.77
Dec,RTGS,2822.05,0,389268.82
Jan,Bill,1715277.5,0,2104546.32
Feb,ATM,0,526136.58,1578409.74
Mar,Reversal,0,197301.22,1381108.52
Apr,Miscellaneous,32321.17,0,1413429.69
May,Miscellaneous,0,141342.97,1272086.72
Jun,IMPS,0,141342.97,1130743.75
Jul,Bill,38616.25,0,1169360
Aug,Bill,0,116936,1052424
Sep,Reversal,144.1,0,1052568.1
Oct,Debit Card,0,131571.01,920997.09
Nov,ATM,0,102333.01,818664.08
Dec,Miscellaneous,0,409332.04,409332.04
Jan,Cash,0,136444.01,272888.03
Feb,Commission,2529.1,0,275417.13
Mar,Purchase,0,137708.57,137708.56
Apr,Cash,0,22951.43,114757.13
May,IMPS,0,16393.88,98363.25
Jun,Purchase,0,32787.75,65575.5
Jul,Reversal,29,0,65604.5
Aug,Cheque,531.7,0,66136.2
Sep,Cheque,0,8267.03,57869.18
Oct,Tax,6.8,0,57875.98
Nov,Miscellaneous,2234.6,0,60110.58
Dec,Cheque,29610.65,0,89721.23
Jan,Reversal,0,29907.08,59814.15
Feb,RTGS,0,6646.02,53168.13
Mar,Transfer,11.3,0,53179.43
Apr,Debit Card,0,5908.83,47270.6
May,Cash,0,15756.87,31513.73
Jun,Purchase,1.7,0,31515.43
Jul,Bill,0,5252.57,26262.86
Aug,Debit Card,0,6565.72,19697.14
Sep,Cash,0,4924.29,14772.86
Oct,NEFT,0,1477.29,13295.57
Nov,Transfer,0,1661.95,11633.62
Dec,Cash,0,2326.72,9306.9
Jan,Transfer,0,1034.1,8272.8
Feb,Cash,4.7,0,8277.5
Mar,Purchase,1133978,0,1142255.5
Apr,Cash,285,0,1142540.5
May,NEFT,1985468,0,3128008.5
Jun,RTGS,3659.8,0,3131668.3
Jul,IMPS,0,782917.08,2348751.22
Aug,Debit Card,16533,0,2365284.22
Sep,Commission,6.8,0,2365291.02
Oct,Cash,0,1182645.51,1182645.51
Nov,Commission,109.22,0,1182754.73
Dec,Commission,17534.9,0,1200289.63
Jan,Transfer,27625.3,0,1227914.93
Feb,Miscellaneous,2248.4,0,1230163.33
Mar,Transfer,0,615081.67,615081.66
Apr,Cheque,0,123016.33,492065.33
May,Miscellaneous,30444.2,0,522509.53
Jun,Cheque,1,0,522510.53
Jul,Cheque,3.81,0,522514.34
Aug,Tax,15151.03,0,537665.37
Sep,RTGS,0,134416.34,403249.03
Oct,Interest,0,44805.45,358443.58
Nov,Transfer,42,0,358485.58
Dec,Transfer,2.24,0,358487.82
Jan,Reversal,0,35848.78,322639.04
Feb,Cheque,0,80659.76,241979.28
Mar,Miscellaneous,4,0,241983.28
Apr,Purchase,50.5,0,242033.78
May,Bill,435.19,0,242468.97
Jun,ATM,105.2,0,242574.17
Jul,Interest,0,30321.77,212252.4
Aug,Debit Card,47.3,0,212299.7
Sep,NEFT,0,21229.97,191069.73
Oct,Cash,41.01,0,191110.74
Nov,Cash,45,0,191155.74
Dec,Cheque,0,63718.58,127437.16
Jan,Interest,88,0,127525.16
Feb,Reversal,0,12752.52,114772.64
Mar,Commission,0,22954.53,91818.11
Apr,Reversal,58.9,0,91877.01
May,Cheque,2,0,91879.01
Jun,Debit Card,3501.85,0,95380.86
Jul,Commission,1551464,0,1646844.86
Aug,IMPS,0,235263.55,1411581.31
Sep,Cash,1074.8,0,1412656.11
Oct,Bill,8,0,1412664.11
Nov,Cheque,5.23,0,1412669.34
Dec,Interest,32158.1,0,1444827.44
Jan,Cash,0,206403.92,1238423.52
Feb,Reversal,624,0,1239047.52
Mar,RTGS,2233.43,0,1241280.95
Apr,Purchase,0,248256.19,993024.76
May,RTGS,0,248256.19,744768.57
Jun,RTGS,0,248256.19,496512.38
Jul,Tax,0,248256.19,248256.19
Aug,Interest,0,124128.1,124128.1
Sep,Tax,0,13792.01,110336.09
Oct,ATM,108504.3,0,218840.39
Nov,NEFT,0,72946.8,145893.59
Dec,NEFT,416.8,0,146310.39
Jan,Reversal,3785,0,150095.39
Feb,Interest,0,15009.54,135085.85
Mar,Reversal,0,27017.17,108068.68
Apr,Miscellaneous,192018.3,0,300086.98
May,Purchase,63.4,0,300150.38
Jun,Cheque,0,37518.8,262631.58
Jul,Cheque,23.4,0,262654.98
Aug,IMPS,0,37522.14,225132.84
Sep,Miscellaneous,0,28141.61,196991.24
Oct,Cheque,0,24623.91,172367.34
Nov,IMPS,0,17236.73,155130.61
Dec,Interest,8,0,155138.61
Jan,Transfer,876006.5,0,1031145.11
Feb,Interest,0,257786.28,773358.83
Mar,ATM,122280,0,895638.83
Apr,Bill,0,111954.85,783683.98
May,NEFT,43.45,0,783727.43
Jun,ATM,0,261242.48,522484.95
Jul,Miscellaneous,46,0,522530.95
Aug,Commission,153716,0,676246.95
Sep,Debit Card,0,84530.87,591716.08
Oct,Tax,0,84530.87,507185.21
Nov,Cheque,0,84530.87,422654.34
Dec,Cash,0,84530.87,338123.47
Jan,Bill,0,338123.47,0
Feb,NEFT,20078,0,20078
Mar,Interest,684641,0,704719
Apr,Transfer,0,234906.33,469812.67
May,Cash,0,52201.41,417611.26
Jun,Purchase,0,208805.63,208805.63
Jul,Cash,40.9,0,208846.53
Aug,NEFT,0,104423.27,104423.26
Sep,Transfer,0,26105.82,78317.44
Oct,Bill,2080189.25,0,2158506.69
Nov,Debit Card,0,431701.34,1726805.35
Dec,RTGS,0,863402.68,863402.68
Jan,RTGS,394.68,0,863797.36
Feb,ATM,383,0,864180.36
Mar,NEFT,623138,0,1487318.36
Apr,Miscellaneous,2198.7,0,1489517.06
May,Interest,9823.1,0,1499340.16
Jun,Interest,0,149934.02,1349406.14
Jul,Interest,4.47,0,1349410.61
Aug,Bill,0,224901.77,1124508.84
Sep,NEFT,59.6,0,1124568.44
Oct,Transfer,177812.8,0,1302381.24
Nov,Commission,0,651190.62,651190.62
Dec,Cash,285.31,0,651475.93
Jan,Cash,220811,0,872286.93
Feb,Purchase,0,436143.47,436143.46
Mar,IMPS,0,48460.38,387683.08
Apr,Transfer,7.82,0,387690.9
May,Miscellaneous,58,0,387748.9
Jun,IMPS,9204.2,0,396953.1
Jul,Purchase,6.13,0,396959.23
Aug,Transfer,0,79391.85,317567.38
Sep,Interest,15,0,317582.38
Oct,Cheque,0,39697.8,277884.58
Nov,Cheque,0.4,0,277884.98
Dec,Bill,0,69471.25,208413.74
Jan,Miscellaneous,1202794.5,0,1411208.24
Feb,Reversal,50686.3,0,1461894.54
Mar,Debit Card,21,0,1461915.54
Apr,Debit Card,36.3,0,1461951.84
May,Interest,1968390,0,3430341.84
Jun,Bill,0,343034.18,3087307.66
Jul,IMPS,0,441043.95,2646263.71
Aug,Purchase,44.9,0,2646308.61
Sep,Reversal,68,0,2646376.61
Oct,Purchase,79275,0,2725651.61
Nov,Tax,506106,0,3231757.61
Dec,Tax,0,403969.7,2827787.91
Jan,Commission,6,0,2827793.91
Feb,Interest,9815.9,0,2837609.81
Mar,Interest,0,2837609.81,0
Apr,Debit Card,11892.1,0,11892.1
May,Interest,0,1982.02,9910.08
Jun,Bill,47.7,0,9957.78
Jul,IMPS,33.3,0,9991.08
Aug,Purchase,0,1248.89,8742.2
Sep,RTGS,0,1457.03,7285.17
Oct,IMPS,0,1457.03,5828.14
Nov,Transfer,0,1942.71,3885.43
Dec,Debit Card,0,388.54,3496.89
Jan,Bill,242061.56,0,245558.45
Feb,Purchase,237813,0,483371.45
Mar,Bill,1,0,483372.45
Apr,Cheque,0,48337.25,435035.2
May,RTGS,148889,0,583924.2
Jun,RTGS,1118919,0,1702843.2
Jul,Cash,3757,0,1706600.2
Aug,NEFT,1.22,0,1706601.42
Sep,Miscellaneous,0,189622.38,1516979.04
Oct,Miscellaneous,0,303395.81,1213583.23
Nov,Debit Card,21195.5,0,1234778.73
Dec,Interest,0,154347.34,1080431.39
Jan,Reversal,0,270107.85,810323.54
Feb,Cash,192797.66,0,1003121.2
Mar,ATM,6.8,0,1003128
Apr,Reversal,5859.4,0,1008987.4
May,RTGS,4,0,1008991.4
Jun,Commission,49534.03,0,1058525.43
Jul,Cheque,0,105852.54,952672.89
Aug,NEFT,0,105852.54,846820.35
Sep,Miscellaneous,43,0,846863.35
Oct,Commission,0,141143.89,705719.46
Nov,Transfer,144637,0,850356.46
Dec,Debit Card,0,212589.12,637767.34
Jan,Transfer,5507.73,0,643275.07
Feb,IMPS,695766.25,0,1339041.32
Mar,Purchase,0,334760.33,1004280.99
Apr,Interest,0,334760.33,669520.66
May,NEFT,0,133904.13,535616.53
Jun,Cash,1819833.2,0,2355449.73
Jul,Interest,1836083,0,4191532.73
Aug,Reversal,0,2095766.37,2095766.36
Sep,Commission,0,349294.39,1746471.97
Oct,Cheque,0,582157.32,1164314.65
Nov,Transfer,51656,0,1215970.65
Dec,Cash,0,121597.07,1094373.58
Jan,Tax,0,121597.06,972776.52
Feb,IMPS,0,162129.42,810647.1
Mar,Cash,414.62,0,811061.72
Apr,Commission,0,162212.34,648849.38
May,NEFT,105187,0,754036.38
Jun,Purchase,0,125672.73,628363.65
Jul,NEFT,174182.5,0,802546.15
Aug,Interest,1239487.75,0,2042033.9
Sep,Cheque,925621.5,0,2967655.4
Oct,Reversal,3957.3,0,2971612.7
Nov,RTGS,0,424516.1,2547096.6
Dec,ATM,1296.5,0,2548393.1
Jan,Transfer,7.24,0,2548400.34
Feb,Commission,332424.2,0,2880824.54
Mar,ATM,43989.25,0,2924813.79
Apr,RTGS,0,324979.31,2599834.48
May,Reversal,0,259983.45,2339851.03
Jun,Bill,0,389975.17,1949875.86
Jul,RTGS,126746.62,0,2076622.48
Aug,Cash,6.7,0,2076629.18
Sep,Transfer,3.1,0,2076632.28
Oct,Transfer,396910,0,2473542.28
Nov,ATM,0,618385.57,1855156.71
Dec,Interest,0,309192.79,1545963.92
Jan,Bill,161.4,0,1546125.32
Feb,Cash,509.2,0,1546634.52
Mar,ATM,2289,0,1548923.52
Apr,Transfer,0,387230.88,1161692.64
May,Cash,30,0,1161722.64
Jun,Bill,2.2,0,1161724.84
Jul,Bill,0,387241.61,774483.23
Aug,Tax,1385.28,0,775868.51
Sep,Transfer,26237.87,0,802106.38
Oct,NEFT,0,114586.63,687519.75
Nov,Miscellaneous,0,137503.95,550015.8
Dec,Miscellaneous,0,55001.58,495014.22
Jan,Purchase,63,0,495077.22
Feb,Cash,0,123769.31,371307.92
Mar,Debit Card,1726476,0,2097783.92
Apr,Reversal,184475,0,2282258.92
May,Debit Card,0,253584.32,2028674.6
Jun,Bill,914461,0,2943135.6
Jul,Reversal,0,294313.56,2648822.04
Aug,IMPS,3544.5,0,2652366.54
Sep,NEFT,0,2652366.54,0
Oct,ATM,492,0,492
Nov,Reversal,332.8,0,824.8
Dec,Cheque,0,274.93,549.87
Jan,IMPS,568611.5,0,569161.37
Feb,Miscellaneous,61,0,569222.37
Mar,Tax,0,0,569222.37
Apr,Purchase,0,113844.47,455377.9
May,IMPS,0,0,455377.9
Jun,NEFT,0,455377.9,0
Jul,Transfer,3,0,3
Aug,NEFT,5,0,8
Sep,Debit Card,0,0.8,7.2
Oct,Debit Card,0,0.72,6.48
Nov,NEFT,9468,0,9474.48
Dec,NEFT,0,1894.9,7579.58
Jan,Transfer,2038.7,0,9618.28
Feb,Transfer,0,9618.28,0
Mar,Transfer,54.34,0,54.34
Apr,Interest,0.1,0,54.44
May,NEFT,794,0,848.44
Jun,ATM,0,141.41,707.03
Jul,Bill,4.31,0,711.34
Aug,Cash,105963.59,0,106674.93
Sep,Tax,22,0,106696.93
Oct,ATM,0,21339.39,85357.54
Nov,Bill,0,21339.39,64018.16
Dec,Transfer,3619.97,0,67638.13
Jan,Commission,0,13527.63,54110.5
Feb,Purchase,0,6012.28,48098.22
Mar,ATM,157,0,48255.22
Apr,Miscellaneous,2356.6,0,50611.82
May,Miscellaneous,5.26,0,50617.08
Jun,Commission,0,12654.27,37962.81
Jul,Commission,1.2,0,37964.01
Aug,Commission,30588,0,68552.01
Sep,Cheque,3.3,0,68555.31
Oct,Bill,0,11425.89,57129.42
Nov,Purchase,24.44,0,57153.86
Dec,RTGS,987,0,58140.86
Jan,Commission,408.7,0,58549.56
Feb,Reversal,0,7318.7,51230.86
Mar,Commission,2,0,51232.86
Apr,Debit Card,55.5,0,51288.36
May,Bill,0,25644.18,25644.18
Jun,IMPS,0,8548.06,17096.12
Jul,Purchase,0,17096.12,0
Aug,RTGS,255621.8,0,255621.8
Sep,RTGS,1518.9,0,257140.7
Oct,Transfer,0,25714.07,231426.63
Nov,Cheque,451,0,231877.63
Dec,NEFT,0,33125.38,198752.25
Jan,ATM,0,24844.03,173908.22
Feb,Commission,510,0,174418.22
Mar,NEFT,3588.72,0,178006.94
Apr,Reversal,0,25429.56,152577.38
May,ATM,0,50859.13,101718.25
Jun,Reversal,416,0,102134.25
Jul,Cash,0,11348.25,90786
Aug,Interest,7,0,90793
Sep,Reversal,0,10088.11,80704.89
Oct,ATM,0,80704.89,0
Nov,Debit Card,2585.8,0,2585.8
Dec,Reversal,12.6,0,2598.4
Jan,Reversal,1974.5,0,4572.9
Feb,IMPS,0.5,0,4573.4
Mar,Tax,844594,0,849167.4
Apr,IMPS,20560,0,869727.4
May,Reversal,239571.5,0,1109298.9
Jun,NEFT,0,1109298.9,0
Jul,Interest,23.4,0,23.4
Aug,Commission,0,23.4,0
Sep,ATM,15785,0,15785
Oct,Tax,7.1,0,15792.1
Nov,ATM,0,7896.05,7896.05
Dec,Transfer,0,987.01,6909.04
Jan,Reversal,16769.6,0,23678.64
Feb,Commission,37,0,23715.64
Mar,Reversal,0,5928.91,17786.73
Apr,NEFT,0,1976.3,15810.43
May,RTGS,1750564.5,0,1766374.93
Jun,IMPS,337.3,0,1766712.23
Jul,RTGS,26.6,0,1766738.83
Aug,Cheque,0,294456.47,1472282.36
Sep,Purchase,0,490760.79,981521.57
Oct,Interest,3036.4,0,984557.97
Nov,Tax,6373.1,0,990931.07
Dec,NEFT,2.2,0,990933.27
Jan,Cheque,0,247733.32,743199.95
Feb,Miscellaneous,0,743199.95,0
Mar,ATM,65746.5,0,65746.5
Apr,Miscellaneous,3.57,0,65750.07
May,Transfer,467,0,66217.07
Jun,Purchase,6.25,0,66223.32
Jul,Purchase,163759.9,0,229983.22
Aug,Commission,0,45996.64,183986.58
Sep,Tax,139.58,0,184126.16
Oct,Purchase,6.93,0,184133.09
Nov,IMPS,5672.16,0,189805.25
Dec,Purchase,5,0,189810.25
Jan,RTGS,513,0,190323.25
Feb,Interest,0,63441.08,126882.17
Mar,Transfer,0,15860.27,111021.9
Apr,IMPS,395,0,111416.9
May,ATM,0,12379.66,99037.24
Jun,IMPS,0,24759.31,74277.93
Jul,Debit Card,127616,0,201893.93
Aug,Interest,27,0,201920.93
Sep,Bill,0,20192.09,181728.84
Oct,ATM,0,22716.11,159012.73
Nov,Miscellaneous,2996.7,0,162009.43
Dec,Purchase,1524830.75,0,1686840.18
Jan,Commission,0,240977.17,1445863.01
Feb,Tax,0,180732.88,1265130.13
Mar,Cheque,0,632565.07,632565.06
Apr,Commission,44.4,0,632609.46
May,Cheque,0,126521.89,506087.57
Jun,Reversal,0,84347.93,421739.64
Jul,Purchase,0,140579.88,281159.76
Aug,ATM,10.8,0,281170.56
Sep,Miscellaneous,154970.3,0,436140.86
Oct,IMPS,0,48460.1,387680.76
Nov,Commission,0,129226.92,258453.84
Dec,IMPS,21.01,0,258474.85
Jan,Transfer,171.3,0,258646.15
Feb,ATM,362.66,0,259008.81
Mar,Cheque,77655,0,336663.81
Apr,Purchase,0,168331.91,168331.9
May,ATM,398.9,0,168730.8
Jun,ATM,0,28121.8,140609
Jul,RTGS,0,46869.67,93739.33
Aug,Cheque,7880,0,101619.33
Sep,Bill,13,0,101632.33
Oct,Interest,3339.6,0,104971.93
Nov,Debit Card,0,52485.97,52485.96
Dec,Reversal,0,52485.96,0
Jan,Bill,285.9,0,285.9
Feb,Bill,0,35.74,250.16
Mar,ATM,200603,0,200853.16
Apr,Miscellaneous,0,25106.65,175746.52
May,Purchase,93977.5,0,269724.02
Jun,IMPS,0,38532,231192.02
Jul,Bill,0,25688,205504.02
Aug,Reversal,0,41100.8,164403.22
Sep,NEFT,0,27400.54,137002.68
Oct,Reversal,59.1,0,137061.78
Nov,RTGS,412,0,137473.78
Dec,IMPS,348,0,137821.78
Jan,Purchase,29509.9,0,167331.68
Feb,Miscellaneous,4479.74,0,171811.42
Mar,Bill,203295.12,0,375106.54
Apr,RTGS,155.9,0,375262.44
May,Purchase,0,62543.74,312718.7
Jun,Tax,34454.3,0,347173
Jul,Transfer,0,69434.6,277738.4
Aug,Tax,0,92579.47,185158.93
Sep,Bill,1844165.5,0,2029324.43
Oct,Transfer,1309717.2,0,3339041.63
Nov,RTGS,20261,0,3359302.63
Dec,Interest,0,3359302.63,0
Jan,ATM,6,0,6
Feb,Cheque,1507864.25,0,1507870.25
Mar,Reversal,8254.9,0,1516125.15
Apr,Interest,0,505375.05,1010750.1
May,Cheque,1,0,1010751.1
Jun,Cheque,156247.4,0,1166998.5
Jul,Commission,1867.95,0,1168866.45
Aug,Cheque,0,166980.92,1001885.53
Sep,Debit Card,0,200377.11,801508.42
Oct,NEFT,0,801508.42,0
Nov,ATM,3046.8,0,3046.8
Dec,Purchase,0,507.8,2539
Jan,RTGS,0,362.71,2176.29
Feb,Miscellaneous,0,241.81,1934.48
Mar,Purchase,0,322.41,1612.07
Apr,Debit Card,2554.3,0,4166.37
May,RTGS,8892.7,0,13059.07
Jun,Bill,851044.2,0,864103.27
Jul,RTGS,233028.8,0,1097132.07
Aug,IMPS,19.1,0,1097151.17
Sep,Bill,1947527.5,0,3044678.67
Oct,Tax,2.3,0,3044680.97
Nov,Bill,275.6,0,3044956.57
Dec,Commission,0,434993.8,2609962.77
Jan,Interest,0,2609962.77,0
Feb,Commission,138537,0,138537
Mar,Purchase,0,15393,123144
Apr,Bill,22.96,0,123166.96
May,Purchase,77667.7,0,200834.66
Jun,Bill,1146.84,0,201981.5
Jul,Purchase,31072.9,0,233054.4
Aug,ATM,1661338.8,0,1894393.2
Sep,Cash,0,189439.32,1704953.88
Oct,Miscellaneous,0,568317.96,1136635.92
Nov,NEFT,30.91,0,1136666.83
Dec,ATM,0,227333.37,909333.46
Jan,Purchase,0,151555.58,757777.88
Feb,IMPS,0,189444.47,568333.41
Mar,Reversal,23,0,568356.41
Apr,Interest,0,113671.28,454685.13
May,Bill,2,0,454687.13
Jun,Transfer,0,56835.89,397851.24
Jul,Reversal,45265,0,443116.24
Aug,Debit Card,0,88623.25,354492.99
Sep,Debit Card,36.23,0,354529.22
Oct,Interest,31279,0,385808.22
Nov,RTGS,0,64301.37,321506.85
Dec,Cheque,4130.6,0,325637.45
Jan,IMPS,0,54272.91,271364.54
Feb,Tax,0,54272.91,217091.63
Mar,Miscellaneous,7,0,217098.63
Apr,Purchase,0,72366.21,144732.42
May,Debit Card,22259,0,166991.42
Jun,Commission,0,20873.93,146117.49
Jul,Cash,9251,0,155368.49
Aug,Transfer,1461229,0,1616597.49
Sep,Debit Card,0,179621.94,1436975.55
Oct,RTGS,52.5,0,1437028.05
Nov,Cheque,0,1437028.05,0
Dec,Cheque,99408,0,99408
Jan,Bill,703093.5,0,802501.5
Feb,Reversal,0,160500.3,642001.2
Mar,Transfer,0,214000.4,428000.8
Apr,Interest,0,142666.93,285333.87
May,Purchase,0,285333.87,0
Jun,Cash,7.2,0,7.2
Jul,Cash,0,1.8,5.4
Aug,IMPS,3,0,8.4
Sep,Commission,2.12,0,10.52
Oct,RTGS,0,1.5,9.02
Nov,Transfer,0,1.29,7.73
Dec,Tax,69,0,76.73
Jan,Tax,0,10.96,65.77
Feb,Tax,0,8.22,57.55
Mar,Transfer,51.3,0,108.85
Apr,Purchase,0,27.21,81.64
May,NEFT,1832.57,0,1914.21
Jun,Purchase,2,0,1916.21
Jul,Debit Card,38.9,0,1955.11
Aug,Cash,0,279.3,1675.81
Sep,RTGS,1092,0,2767.81
Oct,Commission,0,307.53,2460.28
Nov,RTGS,111.99,0,2572.27
Dec,Interest,216.19,0,2788.46
Jan,Reversal,30022.9,0,32811.36
Feb,Cheque,0,10937.12,21874.24
Mar,Bill,49,0,21923.24
Apr,Commission,0,2192.32,19730.92
May,Purchase,0,2818.7,16912.22
Jun,IMPS,198991,0,215903.22
Jul,RTGS,410,0,216313.22
Aug,Bill,127,0,216440.22
Sep,Purchase,195641.7,0,412081.92
Oct,Cash,6.5,0,412088.42
Nov,Tax,7.01,0,412095.43
Dec,Transfer,119242.8,0,531338.23
Jan,Cash,0,53133.82,478204.41
Feb,IMPS,0,119551.1,358653.31
Mar,Transfer,2024514,0,2383167.31
Apr,Reversal,1874589.75,0,4257757.06
May,Bill,0,4257757.06,0
Jun,Debit Card,4,0,4
Jul,Transfer,0,0,4
Aug,RTGS,52354.1,0,52358.1
Sep,Cheque,4.41,0,52362.51
Oct,Transfer,0,5818.06,46544.45
Nov,IMPS,99847,0,146391.45
Dec,RTGS,0,14639.15,131752.31
Jan,Tax,0,131752.31,0
Feb,Cheque,156841.2,0,156841.2
Mar,Cash,223.4,0,157064.6
Apr,Commission,259355,0,416419.6
May,Interest,0,416419.6,0
Jun,Interest,2150.09,0,2150.09
Jul,Reversal,2024110,0,2026260.09
Aug,Interest,27.5,0,2026287.59
Sep,RTGS,0,202628.76,1823658.83
Oct,NEFT,17977.24,0,1841636.07
Nov,Transfer,6,0,1841642.07
Dec,Reversal,0,613880.69,1227761.38
Jan,Tax,0,409253.79,818507.59
Feb,NEFT,0.74,0,818508.33
Mar,Cash,0,90945.37,727562.96
Apr,Debit Card,0,90945.37,636617.59
May,Cheque,0,212205.86,424411.73
Jun,Cheque,0,212205.87,212205.86
Jul,ATM,0,30315.12,181890.74
Aug,Reversal,0,181890.74,0
Sep,Interest,78188.1,0,78188.1
Oct,RTGS,214.8,0,78402.9
Nov,Reversal,0,13067.15,65335.75
Dec,RTGS,20382.8,0,85718.55
Jan,Interest,0,12245.51,73473.04
Feb,Cheque,0,14694.61,58778.43
Mar,Purchase,0,19592.81,39185.62
Apr,Cheque,0,4898.2,34287.42
May,Tax,18299,0,52586.42
Jun,Tax,0,7512.35,45074.07
Jul,Purchase,0,6439.15,38634.92
Aug,Interest,0,3863.49,34771.43
Sep,Transfer,0,11590.48,23180.95
Oct,Cheque,469569.2,0,492750.15
Nov,Miscellaneous,0,54750.02,438000.13
Dec,ATM,54.4,0,438054.53
Jan,Interest,320,0,438374.53
Feb,NEFT,0,219187.27,219187.26
Mar,Reversal,3254.1,0,222441.36
Apr,ATM,2165.03,0,224606.39
May,Interest,0,224606.39,0
Jun,Debit Card,3.25,0,3.25
Jul,Cash,0,0.33,2.92
Aug,Cheque,62151,0,62153.92
Sep,Cash,0,15538.48,46615.44
Oct,Reversal,0,7769.24,38846.2
Nov,Bill,0,38846.2,0
Dec,IMPS,146.74,0,146.74
Jan,Miscellaneous,0,20.96,125.78
Feb,Bill,2.36,0,128.14
Mar,Cash,10121.6,0,10249.74
Apr,Miscellaneous,253247,0,263496.74
May,ATM,0,29277.42,234219.32
Jun,Purchase,0,26024.37,208194.95
Jul,Interest,0,20819.5,187375.46
Aug,Miscellaneous,744654,0,932029.46
Sep,Reversal,28490.3,0,960519.76
Oct,Transfer,840883.25,0,1801403.01
Nov,RTGS,0,1801403.01,0
Dec,Cheque,11841,0,11841
Jan,Debit Card,0,2368.2,9472.8
Feb,RTGS,0,947.28,8525.52
Mar,RTGS,817640,0,826165.52
Apr,Transfer,0,275388.51,550777.01
May,Debit Card,150373.19,0,701150.2
Jun,NEFT,127739,0,828889.2
Jul,RTGS,0,165777.84,663111.36
Aug,Debit Card,511,0,663622.36
Sep,Cash,0,73735.82,589886.54
Oct,Cheque,0,117977.31,471909.23
Nov,NEFT,0,117977.31,353931.92
Dec,Reversal,21707,0,375638.92
Jan,RTGS,113.12,0,375752.04
Feb,Cash,0,62625.34,313126.7
Mar,Purchase,0,313126.7,0
Apr,Cheque,182921.59,0,182921.59
May,IMPS,24460.91,0,207382.5
Jun,Cheque,0,20738.25,186644.25
Jul,Miscellaneous,0,186644.25,0
Aug,Miscellaneous,25,0,25
Sep,Miscellaneous,0,3.13,21.88
Oct,Tax,458.9,0,480.78
Nov,Transfer,0,68.68,412.1
Dec,Transfer,275,0,687.1
Jan,Tax,0,171.78,515.33
Feb,IMPS,561576,0,562091.33
Mar,Cash,0,70261.42,491829.91
Apr,Transfer,0,54647.77,437182.14
May,Commission,0,109295.54,327886.6
Jun,Commission,0,32788.66,295097.94
Jul,RTGS,2,0,295099.94
Aug,NEFT,0,32788.88,262311.06
Sep,NEFT,130,0,262441.06
Oct,Debit Card,0,43740.18,218700.88
Nov,Reversal,670400,0,889100.88
Dec,Debit Card,3.1,0,889103.98
Jan,Tax,0,88910.4,800193.58
Feb,RTGS,2518.72,0,802712.3
Mar,Commission,48901.38,0,851613.68
Apr,Purchase,5908.5,0,857522.18
May,IMPS,0,214380.55,643141.64
Jun,Miscellaneous,17,0,643158.64
Jul,Commission,139110.8,0,782269.44
Aug,Purchase,14.7,0,782284.14
Sep,IMPS,1470359.5,0,2252643.64
Oct,Commission,0,281580.46,1971063.18
Nov,Debit Card,0,197106.32,1773956.86
Dec,Interest,0,443489.22,1330467.64
Jan,NEFT,0,665233.82,665233.82
Feb,RTGS,8,0,665241.82
Mar,Cheque,0,110873.64,554368.18
Apr,Interest,51.95,0,554420.13
May,Commission,56.9,0,554477.03
Jun,Debit Card,47.2,0,554524.23
Jul,Interest,0,110904.85,443619.38
Aug,Reversal,0,73936.56,369682.82
Sep,Commission,0,61613.8,308069.02
Oct,Purchase,0,51344.84,256724.18
Nov,RTGS,59,0,256783.18
Dec,RTGS,0,28531.46,228251.72
Jan,IMPS,1895747.5,0,2123999.22
Feb,Cheque,0.08,0,2123999.3
Mar,IMPS,35.77,0,2124035.07
Apr,RTGS,7.34,0,2124042.41
May,Interest,511.11,0,2124553.52
Jun,RTGS,0,708184.51,1416369.01
Jul,Cash,0,708184.51,708184.5
Aug,Commission,16,0,708200.5
Sep,Purchase,0,708200.5,0
Oct,Cash,11692.14,0,11692.14
Nov,Tax,0,1670.31,10021.83
Dec,Cheque,1.2,0,10023.03
Jan,IMPS,0,1002.3,9020.73
Feb,Tax,8602.2,0,17622.93
Mar,ATM,0,4405.73,13217.2
Apr,Miscellaneous,8386.2,0,21603.4
May,Debit Card,0,2400.38,19203.02
Jun,Debit Card,6.31,0,19209.33
Jul,Reversal,183,0,19392.33
Aug,Tax,0,19392.33,0
Sep,Transfer,96253.3,0,96253.3
Oct,Reversal,0,24063.33,72189.98
Nov,Interest,31,0,72220.98
Dec,RTGS,0,18055.25,54165.74
Jan,ATM,0,7737.96,46427.78
Feb,Interest,0,7737.96,38689.82
Mar,Cash,1436,0,40125.82
Apr,NEFT,42,0,40167.82
May,Cash,0,13389.27,26778.55
Jun,Miscellaneous,14683.38,0,41461.93
Jul,Reversal,38.4,0,41500.33
Aug,Cheque,0,41500.33,0
Sep,Debit Card,133.4,0,133.4
Oct,Tax,0,44.47,88.93
Nov,Interest,2923.32,0,3012.25
Dec,IMPS,0,753.06,2259.19
Jan,Cash,484.04,0,2743.23
Feb,ATM,0,457.21,2286.02
Mar,Reversal,1635440,0,1637726.02
Apr,Interest,4.4,0,1637730.42
May,NEFT,0,233961.49,1403768.93
Jun,Interest,0,280753.79,1123015.14
Jul,Commission,0,140376.89,982638.25
Aug,Purchase,42,0,982680.25
Sep,ATM,1769,0,984449.25
Oct,Miscellaneous,0,328149.75,656299.5
Nov,NEFT,0,109383.25,546916.25
Dec,Reversal,0,54691.63,492224.62
Jan,Bill,0,246112.31,246112.31
Feb,Debit Card,11569,0,257681.31
Mar,Tax,62.2,0,257743.51
Apr,Tax,216,0,257959.51
May,NEFT,48.64,0,258008.15
Jun,Transfer,0,25800.82,232207.34
Jul,Tax,28.3,0,232235.64
Aug,Reversal,0,33176.52,199059.12
Sep,Cheque,6843.69,0,205902.81
Oct,Debit Card,287341.25,0,493244.06
Nov,Tax,828.89,0,494072.95
Dec,Miscellaneous,188235,0,682307.95
Jan,ATM,0,227435.98,454871.97
Feb,IMPS,0,64981.71,389890.26
Mar,ATM,0,38989.03,350901.23
Apr,RTGS,2.69,0,350903.92
May,Miscellaneous,0,175451.96,175451.96
Jun,NEFT,21,0,175472.96
Jul,Purchase,15562,0,191034.96
Aug,Tax,6.95,0,191041.91
Sep,Miscellaneous,37069.81,0,228111.72
Oct,Transfer,1075030.2,0,1303141.92
Nov,Transfer,0,144793.55,1158348.37
Dec,Commission,0,1158348.37,0
Jan,Commission,2188.27,0,2188.27
Feb,Cash,0,312.61,1875.66
Mar,Miscellaneous,21558,0,23433.66
Apr,Bill,0,4686.73,18746.93
May,Tax,0,3749.39,14997.54
Jun,Purchase,56.28,0,15053.82
Jul,Bill,218999.8,0,234053.62
Aug,Transfer,31083,0,265136.62
Sep,RTGS,0,66284.16,198852.46
Oct,Purchase,14,0,198866.46
Nov,Debit Card,0,33144.41,165722.05
Dec,Purchase,0,55240.68,110481.37
Jan,Interest,3314.4,0,113795.77
Feb,Tax,13099,0,126894.77
Mar,Interest,0,42298.26,84596.51
Apr,Tax,0,16919.3,67677.21
May,Miscellaneous,87349.5,0,155026.71
Jun,Debit Card,0,77513.36,77513.36
Jul,Cash,0,9689.17,67824.19
Aug,Bill,14218,0,82042.19
Sep,Miscellaneous,383,0,82425.19
Oct,IMPS,0,8242.52,74182.67
Nov,IMPS,0,14836.53,59346.14
Dec,Purchase,0,14836.54,44509.6
Jan,Purchase,25.8,0,44535.4
Feb,Tax,0,22267.7,22267.7
Mar,Cash,37.92,0,22305.62
Apr,NEFT,0,7435.21,14870.41
May,Cheque,0,1652.27,13218.14
Jun,Interest,183038,0,196256.14
Jul,Bill,85536,0,281792.14
Aug,Bill,2002,0,283794.14
Sep,Commission,102780.2,0,386574.34
Oct,Miscellaneous,0,48321.79,338252.55
Nov,Reversal,4,0,338256.55
Dec,Cheque,0,112752.18,225504.37
Jan,Cash,0,25056.04,200448.33
Feb,ATM,0,20044.83,180403.5
Mar,Debit Card,0,180403.5,0
Apr,Debit Card,3759.28,0,3759.28
May,Purchase,505079.5,0,508838.78
Jun,Debit Card,70.22,0,508909
Jul,Cheque,0,56545.44,452363.56
Aug,Miscellaneous,11659.1,0,464022.66
Sep,NEFT,0,232011.33,232011.33
Oct,Bill,0,38668.56,193342.78
Nov,Bill,0,32223.8,161118.98
Dec,Tax,21977,0,183095.98
Jan,Interest,0,36619.2,146476.78
Feb,RTGS,0,29295.36,117181.42
Mar,NEFT,2715,0,119896.42
Apr,Cheque,1176203,0,1296099.42
May,Cash,5.52,0,1296104.94
Jun,Commission,191136.25,0,1487241.19
Jul,Miscellaneous,0,1487241.19,0
Aug,Miscellaneous,7,0,7
Sep,Interest,0,1,6
Oct,Bill,179.14,0,185.14
Nov,Cheque,0,20.57,164.57
Dec,Interest,874,0,1038.57
Jan,Tax,0,115.4,923.17
Feb,Cheque,237072.78,0,237995.95
Mar,Cash,0,79331.98,158663.97
Apr,Transfer,2537,0,161200.97
May,Cheque,0,16120.1,145080.87
Jun,NEFT,122413,0,267493.87
Jul,IMPS,5,0,267498.87
Aug,Tax,0,29722.1,237776.77
Sep,ATM,11979.8,0,249756.57
Oct,Interest,0,62439.14,187317.43
Nov,Purchase,29286,0,216603.43
Dec,Transfer,0,108301.72,108301.72
Jan,RTGS,1231440,0,1339741.72
Feb,Bill,0,148860.19,1190881.53
Mar,ATM,45,0,1190926.53
Apr,Interest,0,238185.31,952741.22
May,Purchase,8,0,952749.22
Jun,Purchase,0,95274.92,857474.3
Jul,Transfer,18,0,857492.3
Aug,Bill,0,85749.23,771743.07
Sep,Debit Card,0,77174.31,694568.76
Oct,Miscellaneous,0,86821.1,607747.66
Nov,Transfer,6.2,0,607753.86
Dec,Transfer,6.79,0,607760.65
Jan,NEFT,3079.1,0,610839.75
Feb,Purchase,0,67871.08,542968.67
Mar,Commission,0,67871.08,475097.59
Apr,RTGS,5,0,475102.59
May,ATM,0,59387.82,415714.77
Jun,Commission,24631,0,440345.77
Jul,Cash,57,0,440402.77
Aug,Miscellaneous,139997.1,0,580399.87
Sep,IMPS,0,290199.94,290199.94
Oct,Interest,451.07,0,290651.01
Nov,Debit Card,0,145325.51,145325.5
Dec,Tax,12,0,145337.5
Jan,NEFT,0,145337.5,0
Feb,Cheque,2171.5,0,2171.5
Mar,Debit Card,0,542.88,1628.62
Apr,ATM,0,1628.62,0
May,Reversal,44,0,44
Jun,Commission,0,6.29,37.71
Jul,Purchase,1,0,38.71
Aug,Cash,0,4.3,34.41
Sep,Debit Card,0,17.21,17.2
Oct,Interest,525,0,542.2
Nov,IMPS,0,67.78,474.43
Dec,Bill,0,237.22,237.22
Jan,IMPS,9486.5,0,9723.72
Feb,NEFT,2632.21,0,12355.93
Mar,Interest,3,0,12358.93
Apr,ATM,2,0,12360.93
May,Reversal,164,0,12524.93
Jun,NEFT,0,1391.66,11133.27
Jul,RTGS,1675559,0,1686692.27
Aug,NEFT,12631.34,0,1699323.61
Sep,Cash,121,0,1699444.61
Oct,Debit Card,0,188827.18,1510617.43
Nov,Bill,66070.25,0,1576687.68
Dec,Reversal,0,394171.92,1182515.76
Jan,Tax,223.8,0,1182739.56
Feb,Cheque,0,1182739.56,0
Mar,Transfer,1225181,0,1225181
Apr,Tax,31236,0,1256417
May,Miscellaneous,0,418805.67,837611.33
Jun,Bill,0,209402.83,628208.5
Jul,Purchase,0,125641.7,502566.8
Aug,IMPS,0,50256.68,452310.12
Sep,ATM,4,0,452314.12
Oct,Cheque,5.66,0,452319.78
Nov,Reversal,201,0,452520.78
Dec,IMPS,0,90504.16,362016.62
Jan,Debit Card,0,51716.66,310299.96
Feb,Debit Card,19960,0,330259.96
Mar,Miscellaneous,0,55043.33,275216.63
Apr,Transfer,0,30579.63,244637
May,ATM,37.4,0,244674.4
Jun,IMPS,0,30584.3,214090.1
Jul,ATM,48.93,0,214139.03
Aug,NEFT,3.5,0,214142.53
Sep,Cash,58,0,214200.53
Oct,RTGS,47520,0,261720.53
Nov,RTGS,0,37388.65,224331.88
Dec,ATM,0,32047.41,192284.47
Jan,Tax,0,48071.12,144213.35
Feb,Debit Card,21,0,144234.35
Mar,NEFT,0,28846.87,115387.48
Apr,Purchase,0,11538.75,103848.73
May,Cash,0,34616.24,69232.49
Jun,Cash,0,6923.25,62309.24
Jul,ATM,59121,0,121430.24
Aug,Reversal,1933990,0,2055420.24
Sep,Transfer,0,411084.05,1644336.19
Oct,Debit Card,22433.4,0,1666769.59
Nov,Interest,321.36,0,1667090.95
Dec,Purchase,0,555696.98,1111393.97
Jan,Debit Card,0,1111393.97,0
Feb,IMPS,305742,0,305742
Mar,Cash,7.7,0,305749.7
Apr,Reversal,2728.1,0,308477.8
May,Bill,1665345.5,0,1973823.3
Jun,Cheque,3069.1,0,1976892.4
Jul,RTGS,3.6,0,1976896
Aug,Reversal,247996,0,2224892
Sep,Tax,443.75,0,2225335.75
Oct,Bill,252,0,2225587.75
Nov,Cash,391.12,0,2225978.87
Dec,Bill,20486,0,2246464.87
Jan,Cash,5.9,0,2246470.77
Feb,Cheque,167,0,2246637.77
Mar,RTGS,2119.31,0,2248757.08
Apr,Purchase,464.7,0,2249221.78
May,RTGS,0,374870.3,1874351.48
Jun,Reversal,23.4,0,1874374.88
Jul,Cheque,0,234296.86,1640078.02
Aug,Cash,159319,0,1799397.02
Sep,Cash,0,224924.63,1574472.39
Oct,Cash,0,1574472.39,0
Nov,NEFT,1281239,0,1281239
Dec,Purchase,0,640619.5,640619.5
Jan,ATM,119.2,0,640738.7
Feb,ATM,60,0,640798.7
Mar,IMPS,0,128159.74,512638.96
Apr,ATM,0,51263.9,461375.06
May,Commission,13920.05,0,475295.11
Jun,Tax,0,79215.85,396079.26
Jul,IMPS,0,49509.91,346569.35
Aug,IMPS,0,346569.35,0
Sep,Interest,1026.2,0,1026.2
Oct,Tax,0,102.62,923.58
Nov,Cash,228.65,0,1152.23
Dec,Miscellaneous,0,1152.23,0
Jan,NEFT,3634,0,3634
Feb,Interest,0,726.8,2907.2
Mar,Purchase,0,726.8,2180.4
Apr,Bill,0,726.8,1453.6
May,NEFT,882,0,2335.6
Jun,Reversal,0,291.95,2043.65
Jul,Commission,0,291.95,1751.7
Aug,Miscellaneous,588.6,0,2340.3
Sep,Purchase,0,585.08,1755.22
Oct,Tax,6,0,1761.22
Nov,Transfer,0,220.15,1541.07
Dec,Debit Card,11621,0,13162.07
Jan,NEFT,2060970.5,0,2074132.57
Feb,IMPS,0,207413.26,1866719.31
Mar,ATM,0,622239.77,1244479.54
Apr,Purchase,20823.2,0,1265302.74
May,Tax,0,632651.37,632651.37
Jun,Interest,215731,0,848382.37
Jul,Debit Card,0,94264.71,754117.66
Aug,Debit Card,0,107731.09,646386.57
Sep,Cash,0,92340.94,554045.63
Oct,Debit Card,3.92,0,554049.55
Nov,Tax,0,69256.19,484793.36
Dec,Interest,0,161597.79,323195.57
Jan,Miscellaneous,1057,0,324252.57
Feb,Purchase,0,162126.29,162126.28
Mar,RTGS,0,20265.79,141860.5
Apr,Miscellaneous,154.96,0,142015.46
May,RTGS,1252054.5,0,1394069.96
Jun,Cash,0,278813.99,1115255.97
Jul,IMPS,0,159322.28,955933.69
Aug,IMPS,0,95593.37,860340.32
Sep,Miscellaneous,1956,0,862296.32
Oct,Miscellaneous,0,172459.26,689837.06
Nov,Reversal,0,86229.63,603607.43
Dec,ATM,0,60360.74,543246.69
Jan,Interest,0,108649.34,434597.35
Feb,Tax,714212.25,0,1148809.6
Mar,Commission,31102.59,0,1179912.19
Apr,Interest,7,0,1179919.19
May,Cash,0,1179919.19,0
Jun,Miscellaneous,191777,0,191777
Jul,Purchase,14,0,191791
Aug,Commission,137706.59,0,329497.59
Sep,Bill,0,32949.76,296547.83
Oct,Purchase,0,42363.98,254183.85
Nov,Tax,431,0,254614.85
Dec,Cash,30.8,0,254645.65
Jan,IMPS,0,42440.94,212204.71
Feb,Miscellaneous,0,53051.18,159153.53
Mar,Tax,6.3,0,159159.83
Apr,Miscellaneous,7.7,0,159167.53
May,Commission,1225.92,0,160393.45
Jun,Transfer,188.64,0,160582.09
Jul,Transfer,46.2,0,160628.29
Aug,Cheque,0,26771.38,133856.91
Sep,Debit Card,0,19122.42,114734.49
Oct,RTGS,173562.4,0,288296.89
Nov,Miscellaneous,0,72074.22,216222.67
Dec,Miscellaneous,0,30888.95,185333.72
Jan,Cheque,434,0,185767.72
Feb,NEFT,36.6,0,185804.32
Mar,Transfer,0,61934.77,123869.55
Apr,Commission,3866.7,0,127736.25
May,NEFT,0,31934.06,95802.19
Jun,IMPS,286.7,0,96088.89
Jul,NEFT,13250,0,109338.89
Aug,Cash,166438.75,0,275777.64
Sep,Commission,0,137888.82,137888.82
Oct,Commission,1398908,0,1536796.82
Nov,Debit Card,191,0,1536987.82
Dec,Commission,7.32,0,1536995.14
Jan,Bill,0,192124.39,1344870.75
Feb,Tax,48.3,0,1344919.05
Mar,Interest,0,192131.29,1152787.76
Apr,IMPS,86.84,0,1152874.6
May,ATM,10.87,0,1152885.47
Jun,NEFT,76268.3,0,1229153.77
Jul,ATM,60142,0,1289295.77
Aug,Bill,0,143255.09,1146040.68
Sep,Debit Card,1175541.5,0,2321582.18
Oct,Interest,9155.08,0,2330737.26
Nov,Bill,0,233073.73,2097663.53
Dec,Commission,0,209766.35,1887897.18
Jan,Debit Card,0,188789.72,1699107.46
Feb,Bill,692424,0,2391531.46
Mar,Cheque,2,0,2391533.46
Apr,Transfer,296,0,2391829.46
May,Debit Card,0,597957.37,1793872.1
Jun,Debit Card,0,199319.12,1594552.98
Jul,Purchase,0,398638.25,1195914.73
Aug,Debit Card,3189.7,0,1199104.43
Sep,IMPS,24574.1,0,1223678.53
Oct,Transfer,0,122367.85,1101310.68
Nov,Cheque,0,1101310.68,0
Dec,Transfer,59,0,59
Jan,Debit Card,1,0,60
Feb,Interest,0,10,50
Mar,RTGS,298571,0,298621
Apr,Cheque,0,149310.5,149310.5
May,Debit Card,0,37327.63,111982.88
Jun,Transfer,4,0,111986.88
Jul,Tax,22453.3,0,134440.18
Aug,Commission,490.3,0,134930.48
Sep,Transfer,11.5,0,134941.98
Oct,Purchase,0,33735.5,101206.49
Nov,Cash,0,11245.17,89961.32
Dec,Cash,0,89961.32,0
Jan,Reversal,1764.8,0,1764.8
Feb,ATM,0,294.13,1470.67
Mar,Purchase,0,735.34,735.34
Apr,Transfer,2551.55,0,3286.89
May,Interest,1939278,0,1942564.89
Jun,Reversal,31.46,0,1942596.35
Jul,Tax,0,647532.12,1295064.23
Aug,Cash,1545.6,0,1296609.83
Sep,ATM,1.83,0,1296611.66
Oct,Bill,511.7,0,1297123.36
Nov,Tax,17,0,1297140.36
Dec,IMPS,0,648570.18,648570.18
Jan,Bill,0,324285.09,324285.09
Feb,Cash,0,54047.52,270237.58
Mar,Transfer,0,54047.52,216190.06
Apr,IMPS,0,36031.68,180158.38
May,Transfer,29,0,180187.38
Jun,Cash,0,60062.46,120124.92
Jul,IMPS,0,13347.21,106777.71
Aug,Commission,0,17796.29,88981.42
Sep,ATM,0,11122.68,77858.74
Oct,Commission,11,0,77869.74
Nov,Debit Card,0,11124.25,66745.49
Dec,Reversal,405,0,67150.49
Jan,Purchase,0,11191.75,55958.74
Feb,Transfer,28.4,0,55987.14
Mar,Transfer,2600.1,0,58587.24
Apr,Bill,0,19529.08,39058.16
May,IMPS,0,39058.16,0
Jun,NEFT,15647.24,0,15647.24
Jul,NEFT,258,0,15905.24
Aug,Reversal,7,0,15912.24
Sep,ATM,0,3182.45,12729.79
Oct,ATM,112,0,12841.79
Nov,Cash,0,2568.36,10273.43
Dec,IMPS,110150,0,120423.43
Jan,Miscellaneous,1683.3,0,122106.73
Feb,Debit Card,0,17443.82,104662.91
Mar,Tax,2959,0,107621.91
Apr,Purchase,0,10762.19,96859.72
May,Tax,9,0,96868.72
Jun,Reversal,1054200.2,0,1151068.92
Jul,Purchase,0,127896.55,1023172.37
Aug,Commission,7.5,0,1023179.87
Sep,RTGS,22490.9,0,1045670.77
Oct,Reversal,10794,0,1056464.77
Nov,Transfer,97944.62,0,1154409.39
Dec,ATM,0,164915.63,989493.76
Jan,Commission,2114.1,0,991607.86
Feb,Debit Card,0,198321.57,793286.29
Mar,Purchase,749200,0,1542486.29
Apr,Reversal,23050.9,0,1565537.19
May,NEFT,0,173948.58,1391588.61
Jun,Cash,609.9,0,1392198.51
Jul,Debit Card,0,174024.81,1218173.7
Aug,Purchase,0,203028.95,1015144.75
Sep,Commission,0,169190.79,845953.96
Oct,Bill,0,211488.49,634465.47
Nov,Transfer,0,63446.55,571018.92
Dec,Reversal,7,0,571025.92
Jan,IMPS,0,571025.92,0
Feb,Interest,668,0,668
Mar,Debit Card,828849,0,829517
Apr,Cash,14558.82,0,844075.82
May,Debit Card,0.3,0,844076.12
Jun,Miscellaneous,0,844076.12,0
Jul,Bill,1773052,0,1773052
Aug,Cash,0,1773052,0
Sep,Purchase,393.9,0,393.9
Oct,ATM,0,56.27,337.63
Nov,IMPS,6.5,0,344.13
Dec,Miscellaneous,0,68.83,275.3
Jan,Cash,0,275.3,0
Feb,Transfer,1.71,0,1.71
Mar,IMPS,0,0.43,1.28
Apr,Cheque,6,0,7.28
May,NEFT,0,0.81,6.47
Jun,Cash,0.6,0,7.07
Jul,Cash,0,0.71,6.36
Aug,Purchase,0,0.71,5.65
Sep,RTGS,3601.28,0,3606.93
Oct,Cheque,3065.8,0,6672.73
Nov,Cash,0,2224.24,4448.49
Dec,Transfer,0,4448.49,0
Jan,Cheque,552,0,552
Feb,ATM,0,184,368
Mar,Debit Card,31482,0,31850
Apr,Reversal,17,0,31867
May,Tax,56268.56,0,88135.56
Jun,Purchase,0,0,88135.56
Jul,IMPS,1830.9,0,89966.46
Aug,Cash,0,89966.46,0
Sep,Interest,1996736,0,1996736
Oct,Bill,77,0,1996813
Nov,Tax,0,665604.33,1331208.67
Dec,Interest,126650,0,1457858.67
Jan,NEFT,231703,0,1689561.67
Feb,Debit Card,0,211195.21,1478366.46
Mar,Reversal,0,1478366.46,0
Apr,Commission,13.88,0,13.88
May,NEFT,3071,0,3084.88
Jun,Miscellaneous,0,3084.88,0
Jul,Cash,9.58,0,9.58
Aug,IMPS,303.22,0,312.8
Sep,Transfer,63.51,0,376.31
Oct,Reversal,3.7,0,380.01
Nov,Miscellaneous,1927.14,0,2307.15
Dec,Transfer,0,576.79,1730.36
Jan,Miscellaneous,2.06,0,1732.42
Feb,Interest,0,346.48,1385.94
Mar,Commission,0,153.99,1231.95
Apr,Cheque,468.24,0,1700.19
May,Commission,458.56,0,2158.75
Jun,Commission,0,2158.75,0
Jul,Interest,216.5,0,216.5
Aug,Miscellaneous,1044.5,0,1261
Sep,IMPS,29,0,1290
Oct,Miscellaneous,411377,0,412667
Nov,Miscellaneous,0,68777.83,343889.17
Dec,Purchase,0,343889.17,0
Jan,Commission,52183.56,0,52183.56
Feb,Purchase,0,26091.78,26091.78
Mar,Commission,51.8,0,26143.58
Apr,Miscellaneous,62750.22,0,88893.8
May,NEFT,296.3,0,89190.1
Jun,Bill,49618.9,0,138809
Jul,Tax,0,15423.22,123385.78
Aug,Tax,48,0,123433.78
Sep,RTGS,0,15429.22,108004.56
Oct,Bill,0,108004.56,0
Nov,Miscellaneous,6.4,0,6.4
Dec,RTGS,1502072,0,1502078.4
Jan,Commission,0,751039.2,751039.2
Feb,Miscellaneous,0,93879.9,657159.3
Mar,Bill,1293207,0,1950366.3
Apr,Purchase,0,975183.15,975183.15
May,Cash,0,139311.88,835871.27
Jun,Debit Card,20775,0,856646.27
Jul,Transfer,0,95182.92,761463.35
Aug,NEFT,0,190365.84,571097.51
Sep,Debit Card,0,71387.19,499710.32
Oct,Bill,0,124927.58,374782.74
Nov,Debit Card,26497,0,401279.74
Dec,Bill,149438.09,0,550717.83
Jan,Purchase,0,137679.46,413038.37
Feb,ATM,0,41303.84,371734.53
Mar,ATM,0,61955.76,309778.78
Apr,Cash,12.44,0,309791.22
May,Reversal,138219,0,448010.22
Jun,RTGS,3138.3,0,451148.52
Jul,ATM,0,56393.57,394754.96
Aug,Cash,37,0,394791.96
Sep,Cheque,71906.56,0,466698.52
Oct,IMPS,0,93339.7,373358.82
Nov,ATM,51.8,0,373410.62
Dec,ATM,0,93352.66,280057.96
Jan,Commission,5.12,0,280063.08
Feb,RTGS,0,280063.08,0
Mar,Miscellaneous,3926.61,0,3926.61
Apr,Miscellaneous,32167.95,0,36094.56
May,Cash,861546.5,0,897641.06
Jun,Debit Card,0,99737.9,797903.16
Jul,Purchase,0,88655.91,709247.25
Aug,Transfer,9274.25,0,718521.5
Sep,Miscellaneous,4.6,0,718526.1
Oct,Cheque,0,179631.53,538894.57
Nov,Tax,0,179631.52,359263.05
Dec,NEFT,0,39918.12,319344.93
Jan,ATM,0,35482.77,283862.16
Feb,Bill,1769560.25,0,2053422.41
Mar,NEFT,0,1026711.21,1026711.2
Apr,Tax,23286,0,1049997.2
May,Bill,17795.44,0,1067792.64
Jun,Commission,0,266948.16,800844.48
Jul,Transfer,21841,0,822685.48
Aug,Commission,0,137114.25,685571.23
Sep,IMPS,3639,0,689210.23
Oct,Transfer,0,86151.28,603058.95
Nov,Tax,606704,0,1209762.95
Dec,ATM,0,201627.16,1008135.79
Jan,IMPS,24662,0,1032797.79
Feb,Cash,44.83,0,1032842.62
Mar,Commission,0,206568.52,826274.1
Apr,ATM,0,118039.16,708234.94
May,Cheque,97,0,708331.94
Jun,Tax,203604.5,0,911936.44
Jul,Debit Card,0,455968.22,455968.22
Aug,Miscellaneous,0,455968.22,0
Sep,Miscellaneous,29023,0,29023
Oct,Cheque,0,5804.6,23218.4
Nov,Debit Card,141.32,0,23359.72
Dec,NEFT,0,2335.97,21023.75
Jan,Commission,1241026.5,0,1262050.25
Feb,Cash,0,157756.28,1104293.97
Mar,RTGS,13868,0,1118161.97
Apr,ATM,0,159737.42,958424.55
May,RTGS,0,95842.46,862582.1
Jun,Cheque,0,107822.76,754759.34
Jul,RTGS,0,83862.15,670897.19
Aug,NEFT,0,111816.2,559080.99
Sep,ATM,2,0,559082.99
Oct,Cheque,0,139770.75,419312.24
Nov,Bill,0,139770.75,279541.49
Dec,Miscellaneous,10837.72,0,290379.21
Jan,Debit Card,7.5,0,290386.71
Feb,Transfer,81298.4,0,371685.11
Mar,NEFT,0,185842.56,185842.56
Apr,RTGS,0,26548.94,159293.62
May,Cheque,0,39823.41,119470.22
Jun,Reversal,0,11947.02,107523.2
Jul,Commission,2141,0,109664.2
Aug,Cheque,314931.75,0,424595.95
Sep,Bill,58.11,0,424654.06
Oct,Bill,1570745.2,0,1995399.26
Nov,Cash,141286,0,2136685.26
Dec,Bill,101.5,0,2136786.76
Jan,Interest,2855.9,0,2139642.66
Feb,IMPS,49.1,0,2139691.76
Mar,RTGS,1517886,0,3657577.76
Apr,Reversal,0,1828788.88,1828788.88
May,Purchase,138527.5,0,1967316.38
Jun,Cheque,0,983658.19,983658.19
Jul,Cheque,18835.6,0,1002493.79
Aug,RTGS,1535.1,0,1004028.89
Sep,Purchase,0,1004028.89,0
Oct,Debit Card,253.26,0,253.26
Nov,RTGS,21.9,0,275.16
Dec,Reversal,162200,0,162475.16
Jan,Cheque,0,18052.8,144422.36
Feb,Tax,1416581.2,0,1561003.56
Mar,Bill,0,1561003.56,0
Apr,NEFT,51.28,0,51.28
May,Debit Card,4.3,0,55.58
Jun,Debit Card,406.13,0,461.71
Jul,Tax,57.5,0,519.21
Aug,Commission,64.99,0,584.2
Sep,RTGS,30425.44,0,31009.64
Oct,Miscellaneous,0,3100.96,27908.68
Nov,Purchase,1995733,0,2023641.68
Dec,IMPS,0,289091.67,1734550.01
Jan,RTGS,16201.1,0,1750751.11
Feb,Tax,0,350150.22,1400600.89
Mar,IMPS,0,140060.09,1260540.8
Apr,Interest,341,0,1260881.8
May,NEFT,2944.7,0,1263826.5
Jun,Commission,338.83,0,1264165.33
Jul,Commission,164769.4,0,1428934.73
Aug,Cash,112863.8,0,1541798.53
Sep,Tax,0,256966.42,1284832.11
Oct,Cheque,56570.5,0,1341402.61
Nov,Miscellaneous,287766,0,1629168.61
Dec,Reversal,114602.22,0,1743770.83
Jan,NEFT,0,174377.08,1569393.75
Feb,ATM,6.9,0,1569400.65
Mar,RTGS,2478,0,1571878.65
Apr,ATM,16.27,0,1571894.92
May,ATM,0,261982.49,1309912.43
Jun,Debit Card,0,130991.24,1178921.19
Jul,NEFT,5,0,1178926.19
Aug,Tax,1861592,0,3040518.19
Sep,Purchase,1.9,0,3040520.09
Oct,Bill,0,337835.57,2702684.52
Nov,Miscellaneous,0,386097.79,2316586.73
Dec,Transfer,2074.02,0,2318660.75
Jan,Commission,0,386443.46,1932217.29
Feb,Interest,0,386443.46,1545773.83
Mar,ATM,50,0,1545823.83
Apr,Cheque,0,193227.98,1352595.85
May,IMPS,0,338148.96,1014446.89
Jun,RTGS,0,101444.69,913002.2
Jul,Interest,28798.7,0,941800.9
Aug,ATM,374352.75,0,1316153.65
Sep,ATM,0,1316153.65,0
Oct,Cheque,32488,0,32488
Nov,Cheque,0,8122,24366
Dec,Miscellaneous,0,2707.33,21658.67
Jan,ATM,0,7219.56,14439.11
Feb,Tax,12.1,0,14451.21
Mar,Interest,0,2408.54,12042.68
Apr,IMPS,0,1720.38,10322.3
May,Interest,0,2064.46,8257.84
Jun,Tax,446.7,0,8704.54
Jul,NEFT,96,0,8800.54
Aug,Purchase,18393.7,0,27194.24
Sep,Transfer,943.9,0,28138.14
Oct,NEFT,861327,0,889465.14
Nov,Cheque,478.3,0,889943.44
Dec,IMPS,0,127134.78,762808.66
Jan,Interest,0,84756.52,678052.14
Feb,Debit Card,1574226,0,2252278.14
Mar,Bill,0,450455.63,1801822.51
Apr,RTGS,1.8,0,1801824.31
May,Tax,0,257403.47,1544420.84
Jun,Bill,0,154442.08,1389978.76
Jul,Debit Card,0,277995.75,1111983.01
Aug,IMPS,97668.3,0,1209651.31
Sep,Reversal,0,1209651.31,0
Oct,RTGS,16810.88,0,16810.88
Nov,Transfer,0,2401.55,14409.33
Dec,Cash,0,2401.56,12007.78
Jan,Purchase,3.22,0,12011
Feb,NEFT,0,4003.67,8007.33
Mar,RTGS,0,1143.9,6863.43
Apr,Interest,0,6863.43,0
May,Cheque,1496822.5,0,1496822.5
Jun,Reversal,18.96,0,1496841.46
Jul,Interest,0,299368.29,1197473.17
Aug,Cash,0,199578.86,997894.31
Sep,Debit Card,0,249473.58,748420.73
Oct,Cheque,5.1,0,748425.83
Nov,Miscellaneous,1970363,0,2718788.83
Dec,Debit Card,0,679697.21,2039091.62
Jan,Bill,2,0,2039093.62
Feb,Commission,0,407818.72,1631274.9
Mar,NEFT,0,233039.27,1398235.63
Apr,Interest,0,349558.91,1048676.72
May,IMPS,0,131084.59,917592.13
Jun,Transfer,0,152932.02,764660.11
Jul,Tax,0,84962.23,679697.88
Aug,RTGS,0,0,679697.88
Sep,Interest,0,113282.98,566414.9
Oct,Miscellaneous,189245.3,0,755660.2
Nov,NEFT,121496,0,877156.2
Dec,Reversal,99009,0,976165.2
Jan,Cheque,124,0,976289.2
Feb,Purchase,49.4,0,976338.6
Mar,Transfer,7098.61,0,983437.21
Apr,Reversal,0,491718.61,491718.6
May,ATM,0,54635.4,437083.2
Jun,ATM,0,48564.8,388518.4
Jul,Reversal,736818,0,1125336.4
Aug,Bill,0,225067.28,900269.12
Sep,Interest,0,900269.12,0
Oct,Debit Card,789235.25,0,789235.25
Nov,Purchase,0,789235.25,0
Dec,Interest,4.77,0,4.77
Jan,Reversal,155,0,159.77
Feb,Commission,62.2,0,221.97
Mar,Debit Card,0,22.2,199.77
Apr,Miscellaneous,1517.3,0,1717.07
May,Commission,1330025.5,0,1331742.57
Jun,Bill,0,1331742.57,0
Jul,Debit Card,338.4,0,338.4
Aug,Tax,0,84.6,253.8
Sep,Transfer,0,36.26,217.54
Oct,NEFT,0,24.17,193.37
Nov,Bill,6674.5,0,6867.87
Dec,Debit Card,0,1373.57,5494.3
Jan,Cheque,34896,0,40390.3
Feb,Debit Card,7.3,0,40397.6
Mar,Miscellaneous,0,6732.93,33664.67
Apr,Purchase,0,3740.52,29924.15
May,Miscellaneous,344,0,30268.15
Jun,ATM,1234562.2,0,1264830.35
Jul,Transfer,0,421610.12,843220.23
Aug,Interest,0.8,0,843221.03
Sep,Bill,0,84322.1,758898.93
Oct,Transfer,3791.6,0,762690.53
Nov,NEFT,0,108955.79,653734.74
Dec,RTGS,0,108955.79,544778.95
Jan,Cash,17169,0,561947.95
Feb,Purchase,724968.2,0,1286916.15
Mar,Cash,34,0,1286950.15
Apr,RTGS,0,1286950.15,0
May,Interest,3798.08,0,3798.08
Jun,Interest,107.41,0,3905.49
Jul,Interest,0,488.19,3417.3
Aug,Miscellaneous,0,341.73,3075.57
Sep,NEFT,0,512.6,2562.98
Oct,Bill,7119.2,0,9682.18
Nov,Reversal,22716,0,32398.18
Dec,IMPS,328107.8,0,360505.98
Jan,Miscellaneous,30587,0,391092.98
Feb,ATM,0,39109.3,351983.68
Mar,ATM,0,70396.74,281586.94
Apr,Purchase,0,56317.39,225269.55
May,Interest,0,56317.39,168952.16
Jun,Interest,0,28158.69,140793.47
Jul,Cheque,1400694,0,1541487.47
Aug,Bill,2921,0,1544408.47
Sep,Transfer,61946.9,0,1606355.37
Oct,RTGS,11949.4,0,1618304.77
Nov,Interest,0.32,0,1618305.09
Dec,Debit Card,0,179811.68,1438493.41
Jan,ATM,0,179811.68,1258681.73
Feb,Tax,6.46,0,1258688.19
Mar,Purchase,0,179812.6,1078875.59
Apr,Commission,4496.9,0,1083372.49
May,Transfer,10365.7,0,1093738.19
Jun,Commission,0,156248.31,937489.88
Jul,Interest,0,187497.98,749991.9
Aug,Reversal,0,149998.38,599993.52
Sep,Cash,3836.3,0,603829.82
Oct,Cash,0,86261.4,517568.42
Nov,Cash,7.7,0,517576.12
Dec,Tax,0,258788.06,258788.06
Jan,NEFT,0,25878.81,232909.25
Feb,Reversal,30.1,0,232939.35
Mar,Interest,2671.53,0,235610.88
Apr,Debit Card,0,58902.72,176708.16
May,Debit Card,1.54,0,176709.7
Jun,Cheque,0,44177.43,132532.28
Jul,Reversal,0,33133.07,99399.21
Aug,ATM,2600,0,101999.21
Sep,NEFT,62.7,0,102061.91
Oct,RTGS,0,20412.38,81649.53
Nov,Interest,0,8164.95,73484.58
Dec,Purchase,2.01,0,73486.59
Jan,Bill,1.17,0,73487.76
Feb,Cheque,151705.5,0,225193.26
Mar,Cash,0,28149.16,197044.1
Apr,Interest,1796809.75,0,1993853.85
May,Reversal,1623344,0,3617197.85
Jun,Tax,0,516742.55,3100455.3
Jul,Tax,0,310045.53,2790409.77
Aug,Cheque,0,279040.98,2511368.79
Sep,NEFT,5.2,0,2511373.99
Oct,ATM,36,0,2511409.99
Nov,Tax,652100,0,3163509.99
Dec,Interest,0,1054503.33,2109006.66
Jan,Transfer,49,0,2109055.66
Feb,Interest,569109,0,2678164.66
Mar,Cheque,0,535632.93,2142531.73
Apr,Interest,229.8,0,2142761.53
May,Commission,417.31,0,2143178.84
Jun,Cash,0,357196.47,1785982.37
Jul,Interest,27,0,1786009.37
Aug,Miscellaneous,2019,0,1788028.37
Sep,Cheque,44,0,1788072.37
Oct,IMPS,0,178807.24,1609265.13
Nov,IMPS,0,402316.28,1206948.85
Dec,Transfer,81,0,1207029.85
Jan,Cheque,2080854.5,0,3287884.35
Feb,Reversal,0,1095961.45,2191922.9
Mar,Commission,0,273990.36,1917932.54
Apr,Cash,1165275.75,0,3083208.29
May,Bill,0,513868.05,2569340.24
Jun,ATM,9435.5,0,2578775.74
Jul,Purchase,186395,0,2765170.74
Aug,RTGS,0,395024.39,2370146.35
Sep,NEFT,403.6,0,2370549.95
Oct,Transfer,0,395091.66,1975458.29
Nov,IMPS,8500.59,0,1983958.88
Dec,Cash,5.04,0,1983963.92
Jan,IMPS,0,396792.78,1587171.14
Feb,Purchase,893575.25,0,2480746.39
Mar,Bill,0,1240373.2,1240373.2
Apr,Cheque,0,177196.17,1063177.03
May,Commission,0,1063177.03,0
Jun,Purchase,4,0,4
Jul,Cheque,0,4,0
Aug,Cash,85.2,0,85.2
Sep,Cash,5.8,0,91
Oct,Purchase,298.54,0,389.54
Nov,Transfer,689671,0,690060.54
Dec,Reversal,0,172515.14,517545.4
Jan,Cash,238379,0,755924.4
Feb,Cash,2938,0,758862.4
Mar,Transfer,324.6,0,759187
Apr,Debit Card,0,84354.11,674832.89
May,Transfer,0,674832.89,0
Jun,Commission,1108.7,0,1108.7
Jul,IMPS,5,0,1113.7
Aug,IMPS,0,1113.7,0
Sep,Reversal,1457838,0,1457838
Oct,Commission,0,208262.57,1249575.43
Nov,Cash,38.3,0,1249613.73
Dec,Tax,0,178516.25,1071097.48
Jan,Tax,10275.1,0,1081372.58
Feb,ATM,2,0,1081374.58
Mar,Cash,127422.38,0,1208796.96
Apr,Cheque,0,402932.32,805864.64
May,RTGS,0,805864.64,0
Jun,ATM,1.44,0,1.44
Jul,Tax,0,0.16,1.28
Aug,NEFT,0,0.16,1.12
Sep,NEFT,40188,0,40189.12
Oct,Commission,4.28,0,40193.4
Nov,NEFT,0,13397.8,26795.6
Dec,Reversal,0,2977.29,23818.31
Jan,Bill,0,2977.29,20841.02
Feb,IMPS,44.44,0,20885.46
Mar,Purchase,0,2983.64,17901.82
Apr,RTGS,0,2557.4,15344.42
May,Reversal,0,15344.42,0
Jun,Reversal,12585.08,0,12585.08
Jul,Cash,29631.5,0,42216.58
Aug,Cheque,488.3,0,42704.88
Sep,Miscellaneous,3970.84,0,46675.72
Oct,Cheque,14920,0,61595.72
Nov,Cheque,0,15398.93,46196.79
Dec,Miscellaneous,0,4619.68,41577.11
Jan,Tax,0,5939.59,35637.52
Feb,Cheque,1274,0,36911.52
Mar,IMPS,0,9227.88,27683.64
Apr,Reversal,207263,0,234946.64
May,IMPS,0,234946.64,0
Jun,Bill,19.55,0,19.55
Jul,Cash,41,0,60.55
Aug,Interest,46.36,0,106.91
Sep,NEFT,0,53.46,53.46
Oct,Debit Card,0,53.46,0
Nov,Transfer,243065.38,0,243065.38
Dec,Transfer,500.48,0,243565.86
Jan,Cheque,0,40594.31,202971.55
Feb,RTGS,0,67657.18,135314.37
Mar,Cheque,0,27062.87,108251.5
Apr,Debit Card,17602,0,125853.5
May,Cash,0,25170.7,100682.8
Jun,ATM,0,14383.26,86299.54
Jul,Cash,91.7,0,86391.24
Aug,IMPS,3,0,86394.24
Sep,Cash,0,17278.85,69115.39
Oct,IMPS,0,9873.63,59241.76
Nov,Commission,27367,0,86608.76
Dec,Tax,974999.8,0,1061608.56
Jan,ATM,0,265402.14,796206.42
Feb,Bill,1738,0,797944.42
Mar,Miscellaneous,0,88660.49,709283.93
Apr,Transfer,0,70928.39,638355.54
May,ATM,0,79794.44,558561.1
Jun,Debit Card,0,279280.55,279280.55
Jul,Bill,2.8,0,279283.35
Aug,Cheque,0,39897.62,239385.73
Sep,Reversal,0,47877.15,191508.58
Oct,Reversal,1632387.2,0,1823895.78
Nov,NEFT,0,911947.89,911947.89
Dec,IMPS,0,455973.95,455973.94
Jan,ATM,1700702.5,0,2156676.44
Feb,Cheque,0,0,2156676.44
Mar,Bill,0,308096.63,1848579.81
Apr,IMPS,15477,0,1864056.81
May,Transfer,0,266293.83,1597762.98
Jun,Reversal,0,266293.83,1331469.15
Jul,Debit Card,0,665734.58,665734.57
Aug,Debit Card,0,133146.91,532587.66
Sep,Tax,133.7,0,532721.36
Oct,Bill,0,76103.05,456618.31
Nov,Cash,0,76103.05,380515.26
Dec,Commission,0,126838.42,253676.84
Jan,Cash,138.7,0,253815.54
Feb,Bill,0,36259.36,217556.18
Mar,Interest,142187.1,0,359743.28
Apr,Cheque,0,44967.91,314775.37
May,Transfer,3897,0,318672.37
Jun,Cash,1247762.25,0,1566434.62
Jul,Tax,0,391608.66,1174825.97
Aug,Reversal,89205.97,0,1264031.94
Sep,Debit Card,0,158003.99,1106027.95
Oct,Cash,0,221205.59,884822.36
Nov,Cash,0,884822.36,0
Dec,RTGS,0.83,0,0.83
Jan,Reversal,7.9,0,8.73
Feb,RTGS,0,0.97,7.76
Mar,Cash,0,1.94,5.82
Apr,IMPS,0,0.97,4.85
May,Cash,476.76,0,481.61
Jun,Miscellaneous,13840.43,0,14322.04
Jul,Interest,0,1790.26,12531.78
Aug,Bill,0,1392.42,11139.36
Sep,ATM,2964.86,0,14104.22
Oct,Miscellaneous,0,2820.84,11283.38
Nov,Commission,2,0,11285.38
Dec,NEFT,1389628,0,1400913.38
Jan,Commission,0,200130.48,1200782.9
Feb,Transfer,0,300195.73,900587.18
Mar,Bill,30845.9,0,931433.08
Apr,Debit Card,3.8,0,931436.88
May,Debit Card,0,116429.61,815007.27
Jun,NEFT,233784.5,0,1048791.77
Jul,IMPS,0,1048791.77,0
Aug,Reversal,769,0,769
Sep,Debit Card,0,256.33,512.67
Oct,Bill,0,256.34,256.33
Nov,Cheque,1,0,257.33
Dec,Miscellaneous,0,25.73,231.6
Jan,Debit Card,254844,0,255075.6
Feb,ATM,191445.28,0,446520.88
Mar,Commission,0,49613.43,396907.45
Apr,Tax,16.92,0,396924.37
May,Cash,0,198462.19,198462.18
Jun,Debit Card,466701,0,665163.18
Jul,RTGS,0,332581.59,332581.59
Aug,ATM,0,166290.8,166290.8
Sep,Commission,227.67,0,166518.47
Oct,Tax,0,18502.05,148016.42
Nov,Debit Card,1,0,148017.42
Dec,RTGS,12799.21,0,160816.63
Jan,Miscellaneous,0,160816.63,0
Feb,Cheque,508,0,508
Mar,Purchase,0,508,0
Apr,NEFT,158312.09,0,158312.09
May,Cheque,4.32,0,158316.41
Jun,Reversal,0,31663.28,126653.13
Jul,Bill,1802.45,0,128455.58
Aug,ATM,11882.5,0,140338.08
Sep,NEFT,0,14033.81,126304.27
Oct,IMPS,15.58,0,126319.85
Nov,Transfer,0,0,126319.85
Dec,Interest,0,15789.98,110529.87
Jan,ATM,0,12281.1,98248.77
Feb,NEFT,230283.5,0,328532.27
Mar,Tax,0,41066.53,287465.74
Apr,ATM,2,0,287467.74
May,ATM,4149,0,291616.74
Jun,Transfer,504.53,0,292121.27
Jul,Cheque,5.7,0,292126.97
Aug,Bill,0,48687.83,243439.14
Sep,RTGS,2.17,0,243441.31
Oct,Purchase,0,30430.16,213011.15
Nov,Transfer,0,71003.72,142007.43
Dec,Miscellaneous,0,47335.81,94671.62
Jan,Commission,78550,0,173221.62
Feb,Cash,0,34644.32,138577.3
Mar,Transfer,234727.9,0,373305.2
Apr,Miscellaneous,0,41478.36,331826.84
May,Tax,7,0,331833.84
Jun,Bill,0,33183.38,298650.46
Jul,Tax,834506,0,1133156.46
Aug,ATM,1139.6,0,1134296.06
Sep,IMPS,0,226859.21,907436.85
Oct,Transfer,504651.2,0,1412088.05
Nov,RTGS,2472.98,0,1414561.03
Dec,Debit Card,15,0,1414576.03
Jan,Bill,39.2,0,1414615.23
Feb,Interest,189201.78,0,1603817.01
Mar,Reversal,6.21,0,1603823.22
Apr,Transfer,2.96,0,1603826.18
May,NEFT,1.8,0,1603827.98
Jun,Interest,0,1603827.98,0
Jul,NEFT,67.2,0,67.2
Aug,Commission,0,33.6,33.6
Sep,Purchase,0,8.4,25.2
Oct,IMPS,0,6.3,18.9
Nov,Cheque,0,4.73,14.18
Dec,Purchase,0,2.84,11.34
Jan,Purchase,45,0,56.34
Feb,Bill,0,6.26,50.08
Mar,Purchase,0,50.08,0
Apr,Reversal,11765.57,0,11765.57
May,Reversal,5,0,11770.57
Jun,Cheque,0,2354.11,9416.46
Jul,Transfer,129.8,0,9546.26
Aug,Cash,0,1060.7,8485.56
Sep,Cheque,0,2121.39,6364.17
Oct,Transfer,0,636.42,5727.75
Nov,Tax,0,5727.75,0
Dec,RTGS,9381.34,0,9381.34
Jan,ATM,1901.06,0,11282.4
Feb,Miscellaneous,0,1128.24,10154.16
Mar,Interest,3845.32,0,13999.48
Apr,IMPS,0,6999.74,6999.74
May,ATM,55,0,7054.74
Jun,RTGS,7.32,0,7062.06
Jul,ATM,0,1765.52,5296.54
Aug,Miscellaneous,123886,0,129182.54
Sep,Purchase,452,0,129634.54
Oct,ATM,0.02,0,129634.56
Nov,IMPS,2042,0,131676.56
Dec,IMPS,0,32919.14,98757.42
Jan,RTGS,8019.4,0,106776.82
Feb,Commission,1743,0,108519.82
Mar,Transfer,0,108519.82,0
Apr,Transfer,7985,0,7985
May,Miscellaneous,424.79,0,8409.79
Jun,ATM,499.6,0,8909.39
Jul,Cash,35,0,8944.39
Aug,Bill,0,1277.77,7666.62
Sep,Interest,188925.94,0,196592.56
Oct,Debit Card,0,32765.43,163827.13
Nov,NEFT,0,18203.01,145624.12
Dec,RTGS,0,72812.06,72812.06
Jan,Transfer,360.68,0,73172.74
Feb,Tax,0,12195.46,60977.28
Mar,Bill,35,0,61012.28
Apr,Commission,0,10168.71,50843.57
May,Miscellaneous,0,6355.45,44488.12
Jun,Interest,0,8897.62,35590.5
Jul,ATM,207.2,0,35797.7
Aug,Purchase,703811,0,739608.7
Sep,ATM,0,105658.39,633950.31
Oct,Purchase,0,126790.06,507160.25
Nov,Transfer,32,0,507192.25
Dec,Purchase,0,84532.04,422660.21
Jan,Cash,0,211330.11,211330.1
Feb,ATM,0,26416.26,184913.84
Mar,Purchase,6.95,0,184920.79
Apr,RTGS,0,184920.79,0
May,Purchase,29772.35,0,29772.35
Jun,Cheque,0,29772.35,0
Jul,Interest,0.39,0,0.39
Aug,Miscellaneous,27778.43,0,27778.82
Sep,Tax,200454.19,0,228233.01
Oct,IMPS,0,114116.51,114116.5
Nov,Cheque,0,22823.3,91293.2
Dec,Cheque,7,0,91300.2
Jan,ATM,0,45650.1,45650.1
Feb,Bill,37.53,0,45687.63
Mar,IMPS,34940.8,0,80628.43
Apr,ATM,0,16125.69,64502.74
May,Bill,470.83,0,64973.57
Jun,NEFT,194537,0,259510.57
Jul,Miscellaneous,0,28834.51,230676.06
Aug,Debit Card,2913,0,233589.06
Sep,Bill,0,58397.27,175191.8
Oct,Miscellaneous,5.81,0,175197.61
Nov,RTGS,29947.4,0,205145.01
Dec,Reversal,63,0,205208.01
Jan,Debit Card,36.1,0,205244.11
Feb,NEFT,6,0,205250.11
Mar,Cash,0,29321.44,175928.67
Apr,Commission,143275.34,0,319204.01
May,Cash,1774,0,320978.01
Jun,Cheque,755824.2,0,1076802.21
Jul,NEFT,6.5,0,1076808.71
Aug,Tax,261253.72,0,1338062.43
Sep,Bill,248414.44,0,1586476.87
Oct,Miscellaneous,0,264412.81,1322064.06
Nov,ATM,0,1322064.06,0
Dec,RTGS,376.73,0,376.73
Jan,RTGS,219693.8,0,220070.53
Feb,Transfer,0,31438.65,188631.88
Mar,Commission,0,37726.38,150905.5
Apr,Bill,0,30181.1,120724.4
May,Bill,0,20120.73,100603.67
Jun,Debit Card,0,100603.67,0
Jul,Debit Card,515251,0,515251
Aug,Commission,54.6,0,515305.6
Sep,Cheque,1,0,515306.6
Oct,Cash,3707.37,0,519013.97
Nov,Bill,441,0,519454.97
Dec,Transfer,0,74207.85,445247.12
Jan,Reversal,1738,0,446985.12
Feb,Commission,0,148995.04,297990.08
Mar,NEFT,0,33110.01,264880.07
Apr,Tax,0,33110.01,231770.06
May,Purchase,16,0,231786.06
Jun,Commission,53.73,0,231839.79
Jul,RTGS,0,115919.9,115919.9
Aug,IMPS,249,0,116168.9
Sep,RTGS,4064.1,0,120233
Oct,RTGS,849669,0,969902
Nov,Cheque,2415,0,972317
Dec,Debit Card,3.35,0,972320.35
Jan,Purchase,0,324106.78,648213.57
Feb,ATM,659208,0,1307421.57
Mar,NEFT,167141.2,0,1474562.77
Apr,IMPS,0,737281.39,737281.38
May,Tax,2609,0,739890.38
Jun,RTGS,0,73989.04,665901.34
Jul,Transfer,0,110983.56,554917.78
Aug,Tax,0,184972.59,369945.19
Sep,Cheque,110328.81,0,480274
Oct,Reversal,29.8,0,480303.8
Nov,NEFT,7.82,0,480311.62
Dec,Cheque,387.4,0,480699.02
Jan,Transfer,0,160233.01,320466.01
Feb,Reversal,3299,0,323765.01
Mar,Transfer,10065.38,0,333830.39
Apr,Miscellaneous,0,37092.27,296738.12
May,ATM,0,59347.62,237390.5
Jun,ATM,1429844,0,1667234.5
Jul,Transfer,0,333446.9,1333787.6
Aug,Commission,5,0,1333792.6
Sep,IMPS,446,0,1334238.6
Oct,Purchase,7,0,1334245.6
Nov,Debit Card,0,222374.27,1111871.33
Dec,Interest,490.4,0,1112361.73
Jan,RTGS,0,556180.87,556180.86
Feb,Reversal,0,92696.81,463484.05
Mar,ATM,448,0,463932.05
Apr,Transfer,1452.7,0,465384.75
May,Bill,0,155128.25,310256.5
Jun,Miscellaneous,0,77564.13,232692.38
Jul,Commission,0,23269.24,209423.14
Aug,NEFT,0,26177.89,183245.25
Sep,Cash,0,22905.66,160339.59
Oct,Reversal,26548,0,186887.59
Nov,Commission,6,0,186893.59
Dec,Cash,424,0,187317.59
Jan,ATM,0,62439.2,124878.39
Feb,Bill,0,13875.38,111003.01
Mar,Bill,97.82,0,111100.83
Apr,Reversal,0,27775.21,83325.62
May,Transfer,208.38,0,83534
Jun,Cash,0,20883.5,62650.5
Jul,Transfer,0,7831.31,54819.19
Aug,Debit Card,100028,0,154847.19
Sep,Tax,3305,0,158152.19
Oct,IMPS,0,79076.1,79076.1
Nov,IMPS,0,11296.59,67779.51
Dec,ATM,4.86,0,67784.37
Jan,RTGS,223167,0,290951.37
Feb,Reversal,0,41564.48,249386.89
Mar,IMPS,375,0,249761.89
Apr,IMPS,6944,0,256705.89
May,Tax,0,128352.95,128352.94
Jun,ATM,109.9,0,128462.84
Jul,ATM,0,16057.86,112404.98
Aug,Debit Card,0,56202.49,56202.49
Sep,Debit Card,238729,0,294931.49
Oct,Miscellaneous,0,36866.44,258065.05
Nov,Purchase,0,25806.51,232258.54
Dec,Purchase,49.2,0,232307.74
Jan,Cash,5.6,0,232313.34
Feb,Purchase,155,0,232468.34
Mar,RTGS,3.6,0,232471.94
Apr,Reversal,0,116235.97,116235.97
May,Interest,6,0,116241.97
Jun,Interest,0,23248.39,92993.58
Jul,Purchase,0,10332.62,82660.96
Aug,Bill,24654,0,107314.96
Sep,Cheque,571132,0,678446.96
Oct,Transfer,3840,0,682286.96
Nov,Commission,1421573,0,2103859.96
Dec,Interest,1825257,0,3929116.96
Jan,Debit Card,0,654852.83,3274264.13
Feb,NEFT,492,0,3274756.13
Mar,Bill,0,327475.61,2947280.52
Apr,Cash,232699.75,0,3179980.27
May,NEFT,0,353331.14,2826649.13
Jun,NEFT,0,314072.13,2512577
Jul,Transfer,0,314072.13,2198504.88
Aug,Cash,467.5,0,2198972.38
Sep,Purchase,0,2198972.38,0
Oct,Cheque,2495.26,0,2495.26
Nov,NEFT,0,623.82,1871.45
Dec,IMPS,11552.2,0,13423.65
Jan,Interest,36,0,13459.65
Feb,RTGS,0,6729.83,6729.82
Mar,ATM,0,2243.27,4486.55
Apr,Tax,0,4486.55,0
May,IMPS,81,0,81
Jun,Commission,0,81,0
Jul,Debit Card,35911.5,0,35911.5
Aug,Commission,0,35911.5,0
Sep,Purchase,8,0,8
Oct,Transfer,0,0.8,7.2
Nov,Commission,3622.08,0,3629.28
Dec,Commission,1052091,0,1055720.28
Jan,ATM,56,0,1055776.28
Feb,RTGS,365264.2,0,1421040.48
Mar,NEFT,0,177630.06,1243410.42
Apr,Tax,0,177630.06,1065780.36
May,Transfer,0,118420.04,947360.32
Jun,Cash,3778,0,951138.32
Jul,IMPS,49.35,0,951187.67
Aug,Cheque,3.57,0,951191.24
Sep,Cheque,4.71,0,951195.95
Oct,NEFT,58.8,0,951254.75
Nov,Miscellaneous,0,118906.84,832347.91
Dec,Commission,0,832347.91,0
Jan,Bill,147689.5,0,147689.5
Feb,Cash,0,18461.19,129228.31
Mar,Tax,5904,0,135132.31
Apr,ATM,32.3,0,135164.61
May,Debit Card,464,0,135628.61
Jun,Bill,2.08,0,135630.69
Jul,Purchase,1.24,0,135631.93
Aug,Bill,1049,0,136680.93
Sep,ATM,0,13668.09,123012.84
Oct,ATM,24,0,123036.84
Nov,Transfer,41.89,0,123078.73
Dec,Transfer,0,20513.12,102565.61
Jan,Commission,0,14652.23,87913.38
Feb,Debit Card,126,0,88039.38
Mar,Commission,4284,0,92323.38
Apr,Purchase,3277.3,0,95600.68
May,Commission,0,9560.07,86040.61
Jun,Cheque,10,0,86050.61
Jul,Purchase,8,0,86058.61
Aug,Tax,0,14343.1,71715.51
Sep,Tax,100.9,0,71816.41
Oct,Miscellaneous,0,7181.64,64634.77
Nov,Commission,0,64634.77,0
Dec,NEFT,2.91,0,2.91
Jan,Interest,0,0.36,2.55
Feb,Bill,37.4,0,39.95
Mar,Transfer,0,13.32,26.63
Apr,Bill,3563.05,0,3589.68
May,Interest,9348.6,0,12938.28
Jun,Debit Card,0,2156.38,10781.9
Jul,Tax,0,1540.27,9241.63
Aug,Transfer,29388.7,0,38630.33
Sep,RTGS,10577.02,0,49207.35
Oct,Purchase,107942.16,0,157149.51
Nov,Debit Card,0,22449.93,134699.58
Dec,Cash,68.6,0,134768.18
Jan,Debit Card,291.5,0,135059.68
Feb,ATM,0,33764.92,101294.76
Mar,Miscellaneous,26932,0,128226.76
Apr,Reversal,0,21371.13,106855.63
May,Reversal,32405,0,139260.63
Jun,Cheque,0,19894.38,119366.25
Jul,ATM,0,13262.92,106103.33
Aug,Miscellaneous,0,53051.67,53051.66
Sep,NEFT,0,17683.89,35367.77
Oct,Interest,2834,0,38201.77
Nov,IMPS,22927.69,0,61129.46
Dec,Cash,0,6112.95,55016.51
Jan,Miscellaneous,1.5,0,55018.01
Feb,RTGS,0,9169.67,45848.34
Mar,Cash,2083.92,0,47932.26
Apr,Cash,484.4,0,48416.66
May,Commission,7.1,0,48423.76
Jun,Reversal,0,8070.63,40353.13
Jul,Commission,0,5044.14,35308.99
Aug,IMPS,0,5884.83,29424.16
Sep,Miscellaneous,40.52,0,29464.68
Oct,IMPS,2754,0,32218.68
Nov,RTGS,0,4027.34,28191.34
Dec,Debit Card,0,3132.37,25058.97
Jan,Interest,100848,0,125906.97
Feb,Tax,32216,0,158122.97
Mar,Bill,35.8,0,158158.77
Apr,Interest,0,31631.75,126527.02
May,Purchase,20.62,0,126547.64
Jun,Cash,2965.4,0,129513.04
Jul,Debit Card,1910723,0,2040236.04
Aug,Interest,0,340039.34,1700196.7
Sep,Debit Card,85482.6,0,1785679.3
Oct,Bill,0,255097.04,1530582.26
Nov,ATM,0,765291.13,765291.13
Dec,Commission,3358.1,0,768649.23
Jan,Cash,125781.94,0,894431.17
Feb,Reversal,24113.74,0,918544.91
Mar,Bill,952697,0,1871241.91
Apr,ATM,0,233905.24,1637336.67
May,RTGS,18678.7,0,1656015.37
Jun,Cash,0,414003.84,1242011.53
Jul,IMPS,0,207001.92,1035009.61
Aug,Debit Card,0,517504.81,517504.8
Sep,Bill,153736.7,0,671241.5
Oct,Transfer,0,67124.15,604117.35
Nov,ATM,0,302058.68,302058.68
Dec,Bill,0,50343.11,251715.57
Jan,Cash,113.7,0,251829.27
Feb,Miscellaneous,1638040,0,1889869.27
Mar,Cheque,0,472467.32,1417401.95
Apr,RTGS,8,0,1417409.95
May,RTGS,0,354352.49,1063057.46
Jun,IMPS,0,106305.75,956751.71
Jul,Purchase,97.02,0,956848.73
Aug,IMPS,8649,0,965497.73
Sep,Reversal,0,137928.25,827569.48
Oct,Purchase,0,413784.74,413784.74
Nov,RTGS,0,206892.37,206892.37
Dec,Interest,0,41378.47,165513.9
Jan,Purchase,0,18390.43,147123.47
Feb,Interest,0,29424.69,117698.78
Mar,Cash,2938.8,0,120637.58
Apr,Transfer,0,24127.52,96510.06
May,Transfer,0,19302.01,77208.05
Jun,Purchase,251676.53,0,328884.58
Jul,Debit Card,1718950,0,2047834.58
Aug,IMPS,0,292547.8,1755286.78
Sep,Bill,325639.5,0,2080926.28
Oct,IMPS,0,520231.57,1560694.71
Nov,Transfer,85546.1,0,1646240.81
Dec,Purchase,4,0,1646244.81
Jan,ATM,221,0,1646465.81
Feb,Interest,360,0,1646825.81
Mar,Interest,4.5,0,1646830.31
Apr,Bill,0,823415.16,823415.16
May,Tax,0,91490.57,731924.59
Jun,IMPS,0,365962.3,365962.3
Jul,Tax,0,40662.48,325299.82
Aug,Cheque,17.9,0,325317.72
Sep,ATM,393.9,0,325711.62
Oct,Transfer,0,81427.91,244283.72
Nov,NEFT,208610.25,0,452893.97
Dec,RTGS,0,90578.79,362315.18
Jan,Cheque,176054.44,0,538369.62
Feb,Cash,0,269184.81,269184.81
Mar,Miscellaneous,106.8,0,269291.61
Apr,Transfer,0,33661.45,235630.16
May,Miscellaneous,208006,0,443636.16
Jun,Purchase,0,44363.62,399272.54
Jul,Transfer,48609,0,447881.54
Aug,Reversal,2636,0,450517.54
Sep,IMPS,0,75086.26,375431.28
Oct,IMPS,0,187715.64,187715.64
Nov,Interest,52.3,0,187767.94
Dec,Reversal,376.82,0,188144.76
Jan,RTGS,0.87,0,188145.63
Feb,Reversal,0,18814.56,169331.07
Mar,Cash,0,24190.15,145140.92
Apr,Transfer,0,14514.09,130626.83
May,NEFT,25077.49,0,155704.32
Jun,ATM,80500,0,236204.32
Jul,Debit Card,0,118102.16,118102.16
Aug,Interest,0,13122.46,104979.7
Sep,NEFT,4.6,0,104984.3
Oct,Bill,4017.2,0,109001.5
Nov,Debit Card,0,27250.38,81751.12
Dec,Purchase,0,11678.73,70072.39
Jan,Reversal,199518.7,0,269591.09
Feb,NEFT,193656.7,0,463247.79
Mar,RTGS,0,463247.79,0
Apr,Bill,13,0,13
May,Transfer,0,4.33,8.67
Jun,Interest,478,0,486.67
Jul,NEFT,0,60.83,425.84
Aug,Cheque,0,60.83,365.01
Sep,RTGS,2,0,367.01
Oct,NEFT,0,36.7,330.31
Nov,Cash,1224725,0,1225055.31
Dec,Reversal,26.9,0,1225082.21
Jan,Bill,0,175011.74,1050070.47
Feb,RTGS,30783,0,1080853.47
Mar,Transfer,3,0,1080856.47
Apr,Interest,3183.77,0,1084040.24
May,Bill,635298,0,1719338.24
Jun,Reversal,0,191037.58,1528300.66
Jul,Commission,0,152830.07,1375470.59
Aug,ATM,0,1375470.59,0
Sep,ATM,4449,0,4449
Oct,ATM,0,1112.25,3336.75
Nov,Commission,2.9,0,3339.65
Dec,Interest,0,1113.22,2226.43
Jan,Cheque,125623.5,0,127849.93
Feb,ATM,619319.2,0,747169.13
Mar,Tax,391.56,0,747560.69
Apr,RTGS,56.9,0,747617.59
May,NEFT,0,93452.2,654165.39
Jun,Interest,0,65416.54,588748.85
Jul,Cash,47,0,588795.85
Aug,Bill,0,98132.64,490663.21
Sep,Reversal,8266,0,498929.21
Oct,Bill,4.86,0,498934.07
Nov,RTGS,0,62366.76,436567.31
Dec,Reversal,49.2,0,436616.51
Jan,RTGS,0,72769.42,363847.09
Feb,Miscellaneous,0,90961.77,272885.32
Mar,Interest,7.36,0,272892.68
Apr,Cheque,180.9,0,273073.58
May,Cash,0,27307.36,245766.22
Jun,Bill,76864,0,322630.22
Jul,Interest,0,322630.22,0
Aug,Tax,7.76,0,7.76
Sep,Tax,0,0.86,6.9
Oct,Transfer,0,0.69,6.21
Nov,Debit Card,0,0.89,5.32
Dec,ATM,2471.3,0,2476.62
Jan,Cheque,6.33,0,2482.95
Feb,Debit Card,0,1241.48,1241.47
Mar,Cash,0,124.15,1117.32
Apr,Bill,35,0,1152.32
May,Cheque,0,384.11,768.21
Jun,Cash,0,768.21,0
Jul,Cheque,370.7,0,370.7
Aug,ATM,0,61.78,308.92
Sep,Commission,0,38.62,270.3
Oct,Debit Card,44,0,314.3
Nov,RTGS,0,34.92,279.38
Dec,Purchase,0,31.04,248.34
Jan,Cheque,0,35.48,212.86
Feb,Reversal,0,70.95,141.91
Mar,ATM,0,28.38,113.53
Apr,Bill,4,0,117.53
May,Purchase,217.1,0,334.63
Jun,Transfer,15227.8,0,15562.43
Jul,Cash,170785.9,0,186348.33
Aug,Bill,0,31058.06,155290.28
Sep,IMPS,0,51763.43,103526.85
Oct,NEFT,878840,0,982366.85
Nov,RTGS,0,491183.43,491183.42
Dec,Debit Card,0,122795.86,368387.56
Jan,Bill,218.1,0,368605.66
Feb,NEFT,0,46075.71,322529.95
Mar,Tax,0,64505.99,258023.96
Apr,ATM,0,86007.99,172015.97
May,Reversal,0,86007.99,86007.98
Jun,Miscellaneous,0,10751,75256.98
Jul,NEFT,0,12542.83,62714.15
Aug,Miscellaneous,0,6968.24,55745.91
Sep,Purchase,25409.27,0,81155.18
Oct,Reversal,24539,0,105694.18
Nov,NEFT,0,26423.55,79270.63
Dec,Miscellaneous,0,11324.38,67946.25
Jan,Tax,0,22648.75,45297.5
Feb,Debit Card,0,6471.07,38826.43
Mar,Miscellaneous,980486,0,1019312.43
Apr,Debit Card,0,254828.11,764484.32
May,ATM,23030,0,787514.32
Jun,Interest,3.42,0,787517.74
Jul,ATM,4226.77,0,791744.51
Aug,Interest,0,113106.36,678638.15
Sep,IMPS,328034,0,1006672.15
Oct,Interest,0,143810.31,862861.84
Nov,NEFT,50463.5,0,913325.34
Dec,NEFT,0,304441.78,608883.56
Jan,Purchase,352.56,0,609236.12
Feb,NEFT,0,609236.12,0
Mar,Miscellaneous,3.5,0,3.5
Apr,Tax,0,1.75,1.75
May,RTGS,0,0.88,0.88
Jun,Bill,206066,0,206066.88
Jul,ATM,0,206066.88,0
Aug,Debit Card,18.1,0,18.1
Sep,Reversal,0,3.62,14.48
Oct,Transfer,0,7.24,7.24
Nov,Miscellaneous,179,0,186.24
Dec,ATM,157336.1,0,157522.34
Jan,Miscellaneous,945550.5,0,1103072.84
Feb,Miscellaneous,0,1103072.84,0
Mar,Cheque,53.77,0,53.77
Apr,Interest,2.7,0,56.47
May,Interest,30,0,86.47
Jun,Commission,130187.2,0,130273.67
Jul,ATM,0,65136.84,65136.84
Aug,Miscellaneous,17846.11,0,82982.95
Sep,Miscellaneous,391,0,83373.95
Oct,ATM,0,8337.4,75036.55
Nov,ATM,0,18759.14,56277.41
Dec,NEFT,0,8039.63,48237.78
Jan,Transfer,0,8039.63,40198.15
Feb,Interest,2312,0,42510.15
Mar,Tax,209,0,42719.15
Apr,Interest,0,4746.57,37972.58
May,Miscellaneous,0,3797.26,34175.32
Jun,Debit Card,22.3,0,34197.62
Jul,Cash,206522.5,0,240720.12
Aug,IMPS,0,34388.59,206331.53
Sep,Bill,0,34388.59,171942.94
Oct,Cheque,0,85971.47,85971.47
Nov,Reversal,3650,0,89621.47
Dec,Commission,3.6,0,89625.07
Jan,Purchase,63.6,0,89688.67
Feb,Bill,495144,0,584832.67
Mar,Interest,0,97472.11,487360.56
Apr,Tax,11877.75,0,499238.31
May,Miscellaneous,0,55470.92,443767.39
Jun,RTGS,0,147922.46,295844.93
Jul,IMPS,0,42263.56,253581.37
Aug,Cash,0,28175.71,225405.66
Sep,Tax,0,56351.42,169054.24
Oct,Reversal,175170,0,344224.24
Nov,NEFT,0,86056.06,258168.18
Dec,IMPS,1543147.8,0,1801315.98
Jan,RTGS,0,600438.66,1200877.32
Feb,Interest,3559.77,0,1204437.09
Mar,Reversal,32067,0,1236504.09
Apr,IMPS,0,247300.82,989203.27
May,RTGS,41.83,0,989245.1
Jun,IMPS,0,123655.64,865589.46
Jul,Bill,3855,0,869444.46
Aug,RTGS,19442,0,888886.46
Sep,Transfer,5,0,888891.46
Oct,Reversal,0,111111.43,777780.03
Nov,Tax,1716.19,0,779496.22
Dec,IMPS,0,259832.07,519664.15
Jan,RTGS,6,0,519670.15
Feb,Interest,0,519670.15,0
Mar,Cash,2009772,0,2009772
Apr,Bill,2.2,0,2009774.2
May,Bill,0,223308.24,1786465.96
Jun,NEFT,992189.2,0,2778655.16
Jul,Transfer,200402.88,0,2979058.04
Aug,Bill,0,1489529.02,1489529.02
Sep,NEFT,300.1,0,1489829.12
Oct,Cheque,0,248304.85,1241524.27
Nov,Tax,0,310381.07,931143.2
Dec,Bill,61039.7,0,992182.9
Jan,Purchase,0,330727.63,661455.27
Feb,Purchase,380,0,661835.27
Mar,Purchase,3.7,0,661838.97
Apr,Bill,0,94548.42,567290.55
May,Interest,44.8,0,567335.35
Jun,Cash,0,189111.78,378223.57
Jul,Tax,0,42024.84,336198.73
Aug,RTGS,0,37355.41,298843.32
Sep,IMPS,445017.5,0,743860.82
Oct,Cash,0,185965.21,557895.62
Nov,Cheque,2427.26,0,560322.88
Dec,Commission,0,280161.44,280161.44
Jan,Debit Card,0,40023.06,240138.38
Feb,NEFT,5.66,0,240144.04
Mar,Reversal,0,40024.01,200120.03
Apr,IMPS,0,66706.68,133413.35
May,Reversal,107888,0,241301.35
Jun,Miscellaneous,0,80433.78,160867.57
Jul,Commission,0,16086.76,144780.81
Aug,NEFT,4.9,0,144785.71
Sep,Commission,0,48261.9,96523.81
Oct,Cash,14680,0,111203.81
Nov,Miscellaneous,0,22240.76,88963.05
Dec,Reversal,0,8896.31,80066.74
Jan,Debit Card,1.72,0,80068.46
Feb,Bill,403.33,0,80471.79
Mar,Transfer,211469.9,0,291941.69
Apr,Transfer,0,291941.69,0
May,RTGS,2638.63,0,2638.63
Jun,Tax,0,659.66,1978.97
Jul,Miscellaneous,311.5,0,2290.47
Aug,Tax,0,286.31,2004.16
Sep,Cash,14172.43,0,16176.59
Oct,Commission,0,3235.32,12941.27
Nov,IMPS,0,3235.32,9705.95
Dec,RTGS,25740.14,0,35446.09
Jan,Transfer,374934.5,0,410380.59
Feb,IMPS,0,58625.8,351754.79
Mar,Transfer,0,351754.79,0
Apr,Reversal,96835,0,96835
May,NEFT,0,13833.57,83001.43
Jun,RTGS,474,0,83475.43
Jul,Bill,0,10434.43,73041
Aug,NEFT,0,14608.2,58432.8
Sep,Bill,959084,0,1017516.8
Oct,Commission,0,145359.54,872157.26
Nov,Interest,20,0,872177.26
Dec,Interest,0,436088.63,436088.63
Jan,RTGS,833.4,0,436922.03
Feb,Tax,19.94,0,436941.97
Mar,Miscellaneous,40.6,0,436982.57
Apr,NEFT,2994,0,439976.57
May,Tax,703170,0,1143146.57
Jun,Commission,0,114314.66,1028831.91
Jul,Commission,0,1028831.91,0
Aug,Interest,17650.62,0,17650.62
Sep,Cheque,3.74,0,17654.36
Oct,Interest,1765101.25,0,1782755.61
Nov,Tax,0,222844.45,1559911.16
Dec,Tax,0,173323.46,1386587.7
Jan,Reversal,0,138658.77,1247928.93
Feb,NEFT,0,207988.16,1039940.77
Mar,Debit Card,19511.3,0,1059452.07
Apr,Bill,1.6,0,1059453.67
May,IMPS,0,353151.22,706302.45
Jun,Debit Card,57235.25,0,763537.7
Jul,RTGS,0,381768.85,381768.85
Aug,Commission,93473,0,475241.85
Sep,Debit Card,0,79206.98,396034.88
Oct,Cash,0,66005.81,330029.07
Nov,Cheque,0,47147.01,282882.06
Dec,Cash,0,282882.06,0
Jan,Reversal,26,0,26
Feb,Reversal,0,3.71,22.29
Mar,Cheque,0,7.43,14.86
Apr,NEFT,59.61,0,74.47
May,Tax,7,0,81.47
Jun,Tax,0,27.16,54.31
Jul,Transfer,2,0,56.31
Aug,IMPS,0,11.26,45.05
Sep,RTGS,0,15.02,30.03
Oct,Reversal,0,4.29,25.74
Nov,Interest,0,6.44,19.3
Dec,Cheque,164.07,0,183.37
Jan,Commission,1469722.5,0,1469905.87
Feb,Interest,0,293981.17,1175924.7
Mar,Tax,0,235184.94,940739.76
Apr,Transfer,169464,0,1110203.76
May,Cheque,21.9,0,1110225.66
Jun,RTGS,197,0,1110422.66
Jul,Interest,0,277605.67,832816.99
Aug,NEFT,0,277605.66,555211.33
Sep,ATM,10.1,0,555221.43
Oct,Purchase,0,61691.27,493530.16
Nov,Debit Card,20563,0,514093.16
Dec,Debit Card,930501.8,0,1444594.96
Jan,Cheque,0,481531.65,963063.31
Feb,NEFT,158.7,0,963222.01
Mar,Tax,3,0,963225.01
Apr,IMPS,623.6,0,963848.61
May,Miscellaneous,38.2,0,963886.81
Jun,IMPS,0,120485.85,843400.96
Jul,Purchase,0,140566.83,702834.13
Aug,Tax,0,87854.27,614979.86
Sep,Transfer,0,307489.93,307489.93
Oct,Debit Card,0,153744.97,153744.96
Nov,Cash,0,21963.57,131781.39
Dec,Interest,16167.98,0,147949.37
Jan,Transfer,319.7,0,148269.07
Feb,Purchase,204,0,148473.07
Mar,IMPS,287.5,0,148760.57
Apr,Transfer,6.66,0,148767.23
May,Bill,250.73,0,149017.96
Jun,Debit Card,0,149017.96,0
Jul,Cheque,3179.88,0,3179.88
Aug,Purchase,0,1589.94,1589.94
Sep,Miscellaneous,387.72,0,1977.66
Oct,Reversal,0,329.61,1648.05
Nov,Cash,3.14,0,1651.19
Dec,Purchase,5,0,1656.19
Jan,Miscellaneous,37.73,0,1693.92
Feb,Purchase,11,0,1704.92
Mar,Miscellaneous,14647.86,0,16352.78
Apr,Interest,0,8176.39,8176.39
May,NEFT,0,4088.2,4088.2
Jun,NEFT,62.8,0,4151
Jul,Purchase,0,415.1,3735.9
Aug,Transfer,399325.8,0,403061.7
Sep,IMPS,114788,0,517849.7
Oct,Miscellaneous,0,517849.7,0
Nov,Interest,385.67,0,385.67
Dec,Commission,0,42.85,342.82
Jan,Cheque,0,342.82,0
Feb,Miscellaneous,468.8,0,468.8
Mar,Debit Card,0,117.2,351.6
Apr,Purchase,288612,0,288963.6
May,IMPS,19231,0,308194.6
Jun,ATM,100285,0,408479.6
Jul,ATM,0,40847.96,367631.64
Aug,IMPS,431,0,368062.64
Sep,RTGS,0,73612.53,294450.11
Oct,NEFT,0,36806.26,257643.85
Nov,Bill,0,42940.64,214703.21
Dec,IMPS,1,0,214704.21
Jan,Tax,0,71568.07,143136.14
Feb,IMPS,563087.25,0,706223.39
Mar,Purchase,1456025,0,2162248.39
Apr,NEFT,241323.6,0,2403571.99
May,Commission,0,801190.66,1602381.33
Jun,Cheque,0,1602381.33,0
Jul,Tax,44.09,0,44.09
Aug,Miscellaneous,2311,0,2355.09
Sep,RTGS,0,235.51,2119.58
Oct,Interest,0,211.96,1907.62
Nov,Cheque,2723.9,0,4631.52
Dec,Tax,0,2315.76,2315.76
Jan,Commission,0,385.96,1929.8
Feb,ATM,1424824.25,0,1426754.05
Mar,NEFT,481882,0,1908636.05
Apr,Cheque,50334.72,0,1958970.77
May,Miscellaneous,0,489742.69,1469228.08
Jun,Miscellaneous,237387.41,0,1706615.49
Jul,Cash,30906.08,0,1737521.57
Aug,Transfer,0,173752.16,1563769.41
Sep,Cash,0,223395.63,1340373.78
Oct,Reversal,0,148930.42,1191443.36
Nov,Interest,214538,0,1405981.36
Dec,Interest,30970,0,1436951.36
Jan,Tax,35.1,0,1436986.46
Feb,Interest,30478,0,1467464.46
Mar,IMPS,53,0,1467517.46
Apr,Reversal,190277.8,0,1657795.26
May,Interest,40570,0,1698365.26
Jun,Purchase,0,169836.53,1528528.73
Jul,RTGS,0,382132.18,1146396.55
Aug,ATM,0,1146396.55,0
Sep,Cash,42,0,42
Oct,NEFT,50983.25,0,51025.25
Nov,Cheque,0,5669.47,45355.78
Dec,Debit Card,0,9071.16,36284.62
Jan,ATM,0,3628.46,32656.16
Feb,Transfer,0,4665.17,27990.99
Mar,ATM,126908,0,154898.99
Apr,Transfer,28644,0,183542.99
May,NEFT,52343.69,0,235886.68
Jun,Commission,0,47177.34,188709.34
Jul,Reversal,0,20967.7,167741.64
Aug,Miscellaneous,424,0,168165.64
Sep,Purchase,361208,0,529373.64
Oct,Transfer,0,66171.71,463201.94
Nov,Transfer,629042,0,1092243.94
Dec,Miscellaneous,813.03,0,1093056.97
Jan,Purchase,0,109305.7,983751.27
Feb,Miscellaneous,0,122968.91,860782.36
Mar,Cash,0,107597.8,753184.56
Apr,Tax,0,753184.56,0
May,Purchase,262222,0,262222
Jun,Miscellaneous,1467.11,0,263689.11
Jul,Transfer,24869,0,288558.11
Aug,Miscellaneous,0,28855.81,259702.3
Sep,Interest,0,32462.79,227239.51
Oct,RTGS,0,37873.25,189366.26
Nov,RTGS,0,18936.63,170429.63
Dec,Transfer,234952.84,0,405382.47
Jan,Purchase,0,81076.49,324305.98
Feb,ATM,0,32430.6,291875.38
Mar,Interest,745374,0,1037249.38
Apr,NEFT,0,259312.35,777937.04
May,Bill,257455.94,0,1035392.98
Jun,Purchase,0,1035392.98,0
Jul,NEFT,31933,0,31933
Aug,Commission,212.6,0,32145.6
Sep,Reversal,31002,0,63147.6
Oct,Cash,0,31573.8,31573.8
Nov,Reversal,0,10524.6,21049.2
Dec,Purchase,48.1,0,21097.3
Jan,NEFT,131861.5,0,152958.8
Feb,Cash,4,0,152962.8
Mar,Cheque,0,21851.83,131110.97
Apr,Debit Card,5.6,0,131116.57
May,Debit Card,0,16389.57,114727
Jun,Bill,0,12747.44,101979.56
Jul,RTGS,0,11331.06,90648.5
Aug,Cash,3931.6,0,94580.1
Sep,Miscellaneous,0,11822.51,82757.59
Oct,Tax,0,27585.86,55171.73
Nov,RTGS,0,6130.19,49041.54
Dec,Purchase,18163,0,67204.54
Jan,Cash,2.19,0,67206.73
Feb,Miscellaneous,0,33603.37,33603.36
Mar,Tax,29480,0,63083.36
Apr,Miscellaneous,0,7009.26,56074.1
May,NEFT,0,5607.41,50466.69
Jun,ATM,247473.2,0,297939.89
Jul,Cash,0,148969.95,148969.94
Aug,Purchase,0.8,0,148970.74
Sep,Interest,0.39,0,148971.13
Oct,Reversal,0,37242.78,111728.35
Nov,Cheque,0,37242.78,74485.57
Dec,IMPS,0,9310.7,65174.87
Jan,Miscellaneous,0,6517.49,58657.38
Feb,Transfer,2,0,58659.38
Mar,Miscellaneous,7,0,58666.38
Apr,Transfer,0,8380.91,50285.47
May,Purchase,488,0,50773.47
Jun,Cheque,21,0,50794.47
Jul,IMPS,0,50794.47,0
Aug,ATM,1984312,0,1984312
Sep,Cheque,0,661437.33,1322874.67
Oct,Cash,1446013.25,0,2768887.92
Nov,Cash,0,307654.21,2461233.71
Dec,ATM,5.6,0,2461239.31
Jan,Purchase,24693.1,0,2485932.41
Feb,Purchase,0,310741.55,2175190.86
Mar,Cash,0,271898.86,1903292
Apr,NEFT,7409,0,1910701
May,Reversal,314,0,1911015
Jun,Transfer,261411.2,0,2172426.2
Jul,Cash,0,1086213.1,1086213.1
Aug,IMPS,2744.85,0,1088957.95
Sep,Bill,216735.81,0,1305693.76
Oct,RTGS,0,145077.08,1160616.68
Nov,Bill,0,116061.67,1044555.01
Dec,RTGS,0,174092.5,870462.51
Jan,Transfer,0,87046.25,783416.26
Feb,Bill,0,261138.75,522277.51
Mar,Commission,0.7,0,522278.21
Apr,ATM,0,522278.21,0
May,Miscellaneous,198298.6,0,198298.6
Jun,IMPS,0,198298.6,0
Jul,NEFT,6,0,6
Aug,ATM,134.9,0,140.9
Sep,ATM,0,28.18,112.72
Oct,IMPS,214511.25,0,214623.97
Nov,Commission,0,107311.99,107311.98
Dec,Bill,0,11923.55,95388.43
Jan,Miscellaneous,378.2,0,95766.63
Feb,Interest,0,10640.74,85125.89
Mar,IMPS,0,42562.95,42562.94
Apr,Commission,54602,0,97164.94
May,RTGS,2684.89,0,99849.83
Jun,RTGS,7.3,0,99857.13
Jul,Bill,1.81,0,99858.94
Aug,Interest,0,11095.44,88763.5
Sep,IMPS,28800,0,117563.5
Oct,Interest,0,29390.88,88172.62
Nov,Bill,0,14695.44,73477.18
Dec,ATM,195883,0,269360.18
Jan,Debit Card,0,67340.05,202020.14
Feb,Bill,57111,0,259131.14
Mar,Miscellaneous,0,86377.05,172754.09
Apr,Reversal,0,24679.16,148074.93
May,Miscellaneous,0,24679.16,123395.78
Jun,RTGS,1744,0,125139.78
Jul,Cash,0,15642.47,109497.31
Aug,IMPS,38.33,0,109535.64
Sep,Interest,0,27383.91,82151.73
Oct,Purchase,0,10268.97,71882.76
Nov,Purchase,0,11980.46,59902.3
Dec,Commission,20458.2,0,80360.5
Jan,Transfer,19.54,0,80380.04
Feb,Cash,0,11482.86,68897.18
Mar,Debit Card,2580.07,0,71477.25
Apr,RTGS,2019041.8,0,2090519.05
May,Debit Card,0,2090519.05,0
Jun,Cash,148144.9,0,148144.9
Jul,Bill,3095.41,0,151240.31
Aug,NEFT,363.24,0,151603.55
Sep,Miscellaneous,0,151603.55,0
Oct,ATM,156137,0,156137
Nov,Bill,153.2,0,156290.2
Dec,Debit Card,0,52096.73,104193.47
Jan,ATM,0,11577.05,92616.42
Feb,Cash,0,10290.71,82325.71
Mar,RTGS,0,13720.95,68604.76
Apr,Purchase,486,0,69090.76
May,IMPS,0,7676.75,61414.01
Jun,Reversal,5403,0,66817.01
Jul,Commission,850.3,0,67667.31
Aug,Cheque,1119.21,0,68786.52
Sep,Cash,0,11464.42,57322.1
Oct,NEFT,0,19107.37,38214.73
Nov,Commission,2075069,0,2113283.73
Dec,Reversal,2734.9,0,2116018.63
Jan,ATM,37173.8,0,2153192.43
Feb,Purchase,0,430638.49,1722553.94
Mar,Reversal,754.12,0,1723308.06
Apr,NEFT,444.6,0,1723752.66
May,NEFT,0,1723752.66,0
Jun,Tax,195,0,195
Jul,NEFT,104734.38,0,104929.38
Aug,Transfer,1799.3,0,106728.68
Sep,Tax,3.6,0,106732.28
Oct,Interest,7.6,0,106739.88
Nov,Cash,0,15248.55,91491.33
Dec,Transfer,0,30497.11,60994.22
Jan,RTGS,1315551.5,0,1376545.72
Feb,Commission,0,344136.43,1032409.29
Mar,ATM,81877,0,1114286.29
Apr,Commission,0,1114286.29,0
May,Debit Card,168955.3,0,168955.3
Jun,Debit Card,0,56318.43,112636.87
Jul,Transfer,0,37545.62,75091.25
Aug,Reversal,0,7509.13,67582.12
Sep,Debit Card,24129.8,0,91711.92
Oct,Miscellaneous,176,0,91887.92
Nov,Commission,2133.44,0,94021.36
Dec,IMPS,0,13431.62,80589.74
Jan,NEFT,1773744.5,0,1854334.24
Feb,Tax,0,927167.12,927167.12
Mar,Interest,2.73,0,927169.85
Apr,RTGS,18158,0,945327.85
May,Purchase,0,472663.93,472663.92
Jun,Tax,0,47266.39,425397.53
Jul,Interest,34.8,0,425432.33
Aug,Cheque,0,70905.39,354526.94
Sep,Cheque,1656.01,0,356182.95
Oct,Purchase,0,39575.88,316607.07
Nov,Commission,29.7,0,316636.77
Dec,Transfer,0,316636.77,0
Jan,ATM,386.4,0,386.4
Feb,Commission,55.35,0,441.75
Mar,Commission,126,0,567.75
Apr,Bill,0,189.25,378.5
May,Bill,0,37.85,340.65
Jun,ATM,1519508.2,0,1519848.85
Jul,Interest,4.68,0,1519853.53
Aug,Purchase,45.6,0,1519899.13
Sep,Miscellaneous,7,0,1519906.13
Oct,Cash,0,759953.07,759953.06
Nov,ATM,19674,0,779627.06
Dec,Reversal,22624.07,0,802251.13
Jan,IMPS,8680.79,0,810931.92
Feb,IMPS,0,162186.38,648745.54
Mar,ATM,0,72082.84,576662.7
Apr,Interest,460.22,0,577122.92
May,Reversal,0,57712.29,519410.63
Jun,Commission,0,519410.63,0
Jul,NEFT,3774.4,0,3774.4
Aug,Miscellaneous,3436,0,7210.4
Sep,Miscellaneous,0,1201.73,6008.67
Oct,Miscellaneous,0,667.63,5341.04
Nov,ATM,0,667.63,4673.41
Dec,IMPS,0,1168.35,3505.06
Jan,Debit Card,1551844,0,1555349.06
Feb,Bill,15216,0,1570565.06
Mar,Purchase,530797,0,2101362.06
Apr,NEFT,0,2101362.06,0
May,IMPS,18379.8,0,18379.8
Jun,Debit Card,373190.25,0,391570.05
Jul,Miscellaneous,224455,0,616025.05
Aug,NEFT,258052.47,0,874077.52
Sep,Cash,100.2,0,874177.72
Oct,Bill,0,87417.77,786759.95
Nov,Reversal,0,87417.77,699342.18
Dec,Cash,243162.84,0,942505.02
Jan,Tax,254.39,0,942759.41
Feb,RTGS,0,117844.93,824914.48
Mar,Miscellaneous,0,412457.24,412457.24
Apr,Commission,0,412457.24,0
May,Cash,2282.78,0,2282.78
Jun,Miscellaneous,49,0,2331.78
Jul,RTGS,0,582.95,1748.84
Aug,NEFT,0,582.95,1165.89
Sep,IMPS,1391754.5,0,1392920.39
Oct,Purchase,0,1392920.39,0
Nov,Miscellaneous,49,0,49
Dec,Purchase,3811.34,0,3860.34
Jan,ATM,0,965.09,2895.26
Feb,Commission,1521781.2,0,1524676.46
Mar,Bill,251,0,1524927.46
Apr,Cheque,0,762463.73,762463.73
May,Cheque,2769,0,765232.73
Jun,Cash,129,0,765361.73
Jul,Reversal,38435.2,0,803796.93
Aug,ATM,0,200949.23,602847.7
Sep,Cheque,0,301423.85,301423.85
Oct,Reversal,183.4,0,301607.25
Nov,Reversal,0,100535.75,201071.5
Dec,Debit Card,29616.64,0,230688.14
Jan,Interest,0,25632.02,205056.12
Feb,Debit Card,19.4,0,205075.52
Mar,Transfer,60.68,0,205136.2
Apr,Commission,169.5,0,205305.7
May,Purchase,280017.5,0,485323.2
Jun,Miscellaneous,3.39,0,485326.59
Jul,ATM,4.71,0,485331.3
Aug,Cheque,0,242665.65,242665.65
Sep,Purchase,0,24266.57,218399.08
Oct,NEFT,5.1,0,218404.18
Nov,Commission,0,218404.18,0
Dec,Bill,32141,0,32141
Jan,RTGS,889575.5,0,921716.5
Feb,Cheque,0,92171.65,829544.85
Mar,Tax,0,207386.21,622158.64
Apr,Commission,0,103693.11,518465.53
May,Reversal,37.8,0,518503.33
Jun,Purchase,0,57611.48,460891.85
Jul,Transfer,0,57611.48,403280.37
Aug,Cheque,3193,0,406473.37
Sep,Reversal,0,67745.56,338727.81
Oct,Bill,0,169363.91,169363.9
Nov,Bill,0,16936.39,152427.51
Dec,RTGS,0,38106.88,114320.63
Jan,IMPS,0,114320.63,0
Feb,Commission,7.6,0,7.6
Mar,Purchase,163,0,170.6
Apr,Transfer,0,34.12,136.48
May,Transfer,0,68.24,68.24
Jun,Debit Card,0,11.37,56.87
Jul,Bill,0,5.69,51.18
Aug,Cash,0,5.69,45.49
Sep,Transfer,0,6.5,38.99
Oct,NEFT,1989366,0,1989404.99
Nov,Interest,0,397881,1591523.99
Dec,Cash,3563.16,0,1595087.15
Jan,RTGS,0,398771.79,1196315.36
Feb,RTGS,32759.4,0,1229074.76
Mar,Bill,4.42,0,1229079.18
Apr,IMPS,286.9,0,1229366.08
May,Miscellaneous,0,122936.61,1106429.47
Jun,Cash,2.23,0,1106431.7
Jul,Transfer,89.4,0,1106521.1
Aug,Bill,0,276630.28,829890.82
Sep,Transfer,473151.5,0,1303042.32
Oct,Tax,0,260608.46,1042433.86
Nov,Bill,92609,0,1135042.86
Dec,Debit Card,0,283760.72,851282.14
Jan,Bill,3260.61,0,854542.75
Feb,Transfer,0,142423.79,712118.96
Mar,Cheque,0,118686.49,593432.47
Apr,Transfer,0,296716.24,296716.24
May,Tax,185.86,0,296902.1
Jun,Cheque,0,296902.1,0
Jul,Transfer,4489,0,4489
Aug,Reversal,67330,0,71819
Sep,Bill,0,17954.75,53864.25
Oct,Reversal,0,6733.03,47131.22
Nov,Transfer,0,47131.22,0
Dec,Cash,928,0,928
Jan,Commission,0,185.6,742.4
Feb,ATM,0,148.48,593.92
Mar,Cash,0,59.39,534.53
Apr,Miscellaneous,167179.1,0,167713.63
May,Miscellaneous,0,16771.36,150942.27
Jun,NEFT,6.9,0,150949.17
Jul,Miscellaneous,0,50316.39,100632.78
Aug,Reversal,0,25158.2,75474.58
Sep,Reversal,16402,0,91876.58
Oct,Transfer,0,18375.32,73501.26
Nov,Interest,0.61,0,73501.87
Dec,Cheque,0,73501.87,0
Jan,Interest,536380.5,0,536380.5
Feb,Tax,0,134095.13,402285.38
Mar,IMPS,0,201142.69,201142.69
Apr,Bill,0,25142.84,175999.85
May,Tax,0,21999.98,153999.87
Jun,Cash,243554.9,0,397554.77
Jul,Transfer,0,397554.77,0
Aug,Cheque,172,0,172
Sep,Cash,121.79,0,293.79
Oct,Interest,58,0,351.79
Nov,Transfer,0,35.18,316.61
Dec,Debit Card,0,31.66,284.95
Jan,IMPS,294,0,578.95
Feb,Commission,0,192.98,385.97
Mar,Bill,23376.36,0,23762.33
Apr,Cheque,0,3960.39,19801.94
May,Bill,27,0,19828.94
Jun,Cash,0,4957.24,14871.7
Jul,Miscellaneous,0,1487.17,13384.53
Aug,ATM,0,2230.76,11153.78
Sep,Cheque,0,1239.31,9914.47
Oct,Commission,0,1101.61,8812.86
Nov,Cheque,29.6,0,8842.46
Dec,RTGS,906,0,9748.46
Jan,NEFT,0,1218.56,8529.9
Feb,Reversal,6.41,0,8536.31
Mar,NEFT,0,853.63,7682.68
Apr,Commission,0,1280.45,6402.23
May,RTGS,0,1280.45,5121.78
Jun,ATM,0,1024.36,4097.42
Jul,Cash,12880,0,16977.42
Aug,Miscellaneous,0,4244.36,12733.06
Sep,Purchase,0,1819.01,10914.05
Oct,Tax,6,0,10920.05
Nov,Purchase,198273.8,0,209193.85
Dec,IMPS,0,104596.93,104596.92
Jan,NEFT,0,14942.42,89654.5
Feb,Cheque,66645.9,0,156300.4
Mar,Bill,550329,0,706629.4
Apr,NEFT,0,176657.35,529972.05
May,Miscellaneous,0,529972.05,0
Jun,Cash,41,0,41
Jul,Purchase,0,5.86,35.14
Aug,Debit Card,5.85,0,40.99
Sep,Bill,7,0,47.99
Oct,Tax,23.12,0,71.11
Nov,Transfer,0,14.22,56.89
Dec,Interest,0,56.89,0
Jan,Transfer,1942208.5,0,1942208.5
Feb,Debit Card,1113304.25,0,3055512.75
Mar,Cheque,7,0,3055519.75
Apr,Cheque,0,3055519.75,0
May,Tax,2075804,0,2075804
Jun,Interest,20.9,0,2075824.9
Jul,IMPS,818.58,0,2076643.48
Aug,Tax,0,259580.44,1817063.04
Sep,Interest,22904,0,1839967.04
Oct,Miscellaneous,133271.8,0,1973238.84
Nov,Purchase,0,493309.71,1479929.13
Dec,Debit Card,0,739964.57,739964.56
Jan,Cheque,438,0,740402.56
Feb,Miscellaneous,467.41,0,740869.97
Mar,IMPS,66619.4,0,807489.37
Apr,Tax,0,403744.69,403744.68
May,ATM,0,40374.47,363370.21
Jun,NEFT,0,36337.02,327033.19
Jul,Cash,1580774,0,1907807.19
Aug,Purchase,1,0,1907808.19
Sep,Bill,0,238476.02,1669332.17
Oct,Cash,275015.25,0,1944347.42
Nov,Debit Card,1445265,0,3389612.42
Dec,Bill,18,0,3389630.42
Jan,Transfer,298.02,0,3389928.44
Feb,Miscellaneous,0,564988.07,2824940.37
Mar,NEFT,3.1,0,2824943.47
Apr,Reversal,178.88,0,2825122.35
May,ATM,1,0,2825123.35
Jun,Cash,2,0,2825125.35
Jul,Debit Card,0,1412562.68,1412562.68
Aug,Interest,0,353140.67,1059422.01
Sep,Bill,5.23,0,1059427.24
Oct,Interest,29.71,0,1059456.95
Nov,NEFT,0,151350.99,908105.96
Dec,Commission,0,129729.42,778376.54
Jan,IMPS,0,97297.07,681079.47
Feb,Bill,390,0,681469.47
Mar,Miscellaneous,0,113578.25,567891.22
Apr,NEFT,19770.51,0,587661.73
May,Cheque,0,97943.62,489718.11
Jun,Cheque,0,61214.76,428503.35
Jul,Purchase,0,214251.68,214251.68
Aug,RTGS,0,21425.17,192826.51
Sep,Cash,0,32137.75,160688.76
Oct,Commission,28.53,0,160717.29
Nov,IMPS,0,32143.46,128573.83
Dec,Transfer,133,0,128706.83
Jan,RTGS,53.25,0,128760.08
Feb,ATM,244023.53,0,372783.61
Mar,Bill,0,41420.4,331363.21
Apr,Transfer,218,0,331581.21
May,NEFT,6.2,0,331587.41
Jun,Cheque,2.5,0,331589.91
Jul,RTGS,3190,0,334779.91
Aug,Commission,0,167389.96,167389.95
Sep,NEFT,105043.31,0,272433.26
Oct,Reversal,9154.5,0,281587.76
Nov,Debit Card,4035.4,0,285623.16
Dec,Transfer,34.3,0,285657.46
Jan,Miscellaneous,60,0,285717.46
Feb,Interest,0,40816.78,244900.68
Mar,Tax,0,48980.14,195920.54
Apr,Tax,0,39184.11,156736.43
May,Debit Card,11341.8,0,168078.23
Jun,Debit Card,5.35,0,168083.58
Jul,ATM,0,18675.95,149407.63
Aug,Debit Card,0,14940.76,134466.87
Sep,Interest,6.05,0,134472.92
Oct,IMPS,55.79,0,134528.71
Nov,Bill,2166.2,0,136694.91
Dec,Debit Card,0,45564.97,91129.94
Jan,Transfer,0,91129.94,0
Feb,Cheque,958.97,0,958.97
Mar,Miscellaneous,0,319.66,639.31
Apr,Purchase,22951.2,0,23590.51
May,ATM,0,11795.26,11795.26
Jun,Interest,220986.16,0,232781.42
Jul,Cheque,19926,0,252707.42
Aug,Commission,3,0,252710.42
Sep,Transfer,0,252710.42,0
Oct,Debit Card,2.9,0,2.9
Nov,Miscellaneous,238994.8,0,238997.7
Dec,RTGS,0,23899.77,215097.93
Jan,Debit Card,131422.9,0,346520.83
Feb,Transfer,0,57753.47,288767.36
Mar,ATM,62120,0,350887.36
Apr,Purchase,4,0,350891.36
May,Bill,0,116963.79,233927.57
Jun,Debit Card,22741,0,256668.57
Jul,Commission,0,128334.29,128334.28
Aug,NEFT,0,128334.28,0
Sep,Purchase,9.14,0,9.14
Oct,Cash,0,3.05,6.09
Nov,IMPS,0,2.03,4.06
Dec,RTGS,0,0.45,3.61
Jan,Cash,0,0.45,3.16
Feb,Miscellaneous,0,1.58,1.58
Mar,Bill,1496.5,0,1498.08
Apr,Reversal,26277,0,27775.08
May,Interest,0,3086.12,24688.96
Jun,Bill,13409,0,38097.96
Jul,Debit Card,2316,0,40413.96
Aug,Transfer,0,6735.66,33678.3
Sep,Cash,3752.56,0,37430.86
Oct,Interest,6,0,37436.86
Nov,Purchase,12.6,0,37449.46
Dec,NEFT,9,0,37458.46
Jan,NEFT,0,5351.21,32107.25
Feb,IMPS,0,3567.47,28539.78
Mar,IMPS,19693.5,0,48233.28
Apr,Interest,85490.8,0,133724.08
May,Tax,0,33431.02,100293.06
Jun,Miscellaneous,0,100293.06,0
Jul,Debit Card,5,0,5
Aug,Bill,8619.65,0,8624.65
Sep,Miscellaneous,0,1232.09,7392.56
Oct,Commission,1200399.2,0,1207791.76
Nov,ATM,7,0,1207798.76
Dec,Bill,0,120779.88,1087018.88
Jan,Tax,0,120779.88,966239
Feb,Cash,16519.29,0,982758.29
Mar,Transfer,0,140394.04,842364.25
Apr,Purchase,0,120337.75,722026.5
May,Interest,0,144405.3,577621.2
Jun,ATM,0,64180.13,513441.07
Jul,Miscellaneous,8,0,513449.07
Aug,Interest,0,102689.81,410759.26
Sep,Debit Card,164996.06,0,575755.32
Oct,Miscellaneous,70,0,575825.32
Nov,NEFT,28703,0,604528.32
Dec,Interest,56.43,0,604584.75
Jan,Transfer,390,0,604974.75
Feb,Debit Card,0,302487.38,302487.38
Mar,ATM,15024,0,317511.38
Apr,Purchase,1.65,0,317513.03
May,Reversal,0,31751.3,285761.73
Jun,Interest,3,0,285764.73
Jul,Cheque,0,31751.64,254013.09
Aug,ATM,959.93,0,254973.02
Sep,NEFT,139282,0,394255.02
Oct,RTGS,1.84,0,394256.86
Nov,Miscellaneous,9,0,394265.86
Dec,Purchase,403.73,0,394669.59
Jan,Debit Card,1949,0,396618.59
Feb,IMPS,0,56659.8,339958.79
Mar,Miscellaneous,0,48565.54,291393.25
Apr,NEFT,0,97131.08,194262.17
May,IMPS,0,194262.17,0
Jun,NEFT,1.25,0,1.25
Jul,Debit Card,363.8,0,365.05
Aug,Commission,0,365.05,0
Sep,IMPS,0.21,0,0.21
Oct,Cash,0,0.04,0.17
Nov,Purchase,0,0.06,0.11
Dec,RTGS,2091655.75,0,2091655.86
Jan,NEFT,0,298807.98,1792847.88
Feb,Commission,5371.21,0,1798219.09
Mar,Debit Card,0,179821.91,1618397.18
Apr,NEFT,7.6,0,1618404.78
May,Cheque,188687.06,0,1807091.84
Jun,Commission,2034.9,0,1809126.74
Jul,Miscellaneous,0,904563.37,904563.37
Aug,Cash,0,90456.34,814107.03
Sep,IMPS,117.21,0,814224.24
Oct,Tax,0,101778.03,712446.21
Nov,Tax,0,71244.62,641201.59
Dec,Purchase,3844,0,645045.59
Jan,NEFT,58.3,0,645103.89
Feb,Reversal,0,71678.21,573425.68
Mar,IMPS,1114.62,0,574540.3
Apr,NEFT,0,287270.15,287270.15
May,Cheque,22703.6,0,309973.75
Jun,Commission,368.66,0,310342.41
Jul,Purchase,8,0,310350.41
Aug,Transfer,2200,0,312550.41
Sep,ATM,841,0,313391.41
Oct,Transfer,3730.1,0,317121.51
Nov,Debit Card,0,35235.72,281885.79
Dec,ATM,0,40269.4,241616.39
Jan,ATM,0,80538.8,161077.59
Feb,Debit Card,21.52,0,161099.11
Mar,Interest,34.8,0,161133.91
Apr,Commission,0,26855.65,134278.26
May,Debit Card,0,26855.65,107422.61
Jun,Reversal,0,26855.65,80566.96
Jul,Debit Card,0,11509.57,69057.39
Aug,Commission,0,6905.74,62151.65
Sep,Miscellaneous,0,12430.33,49721.32
Oct,Transfer,0,4972.13,44749.19
Nov,Commission,31,0,44780.19
Dec,Reversal,268498.75,0,313278.94
Jan,Miscellaneous,50,0,313328.94
Feb,RTGS,1969256,0,2282584.94
Mar,IMPS,0,228258.49,2054326.45
Apr,Interest,51.6,0,2054378.05
May,Cash,11435.5,0,2065813.55
Jun,Cheque,2700.2,0,2068513.75
Jul,ATM,213366.6,0,2281880.35
Aug,Tax,33.2,0,2281913.55
Sep,IMPS,1076262.5,0,3358176.05
Oct,Miscellaneous,0,335817.61,3022358.44
Nov,Miscellaneous,792448,0,3814806.44
Dec,Debit Card,267820,0,4082626.44
Jan,NEFT,3488,0,4086114.44
Feb,Cheque,0,4086114.44,0
Mar,Reversal,1768683,0,1768683
Apr,Reversal,674782.75,0,2443465.75
May,Purchase,72256,0,2515721.75
Jun,Interest,1416884,0,3932605.75
Jul,RTGS,1845238,0,5777843.75
Aug,Debit Card,60.39,0,5777904.14
Sep,NEFT,0,1925968.05,3851936.09
Oct,Debit Card,0,385193.61,3466742.48
Nov,Reversal,450.31,0,3467192.79
Dec,IMPS,0,866798.2,2600394.59
Jan,Cheque,0,260039.46,2340355.13
Feb,Tax,0,260039.46,2080315.67
Mar,Purchase,0,297187.95,1783127.72
Apr,IMPS,924.36,0,1784052.08
May,RTGS,1392621.5,0,3176673.58
Jun,Purchase,31,0,3176704.58
Jul,Bill,0,635340.92,2541363.66
Aug,ATM,5.7,0,2541369.36
Sep,RTGS,0,423561.56,2117807.8
Oct,Purchase,0,705935.93,1411871.87
Nov,NEFT,0,141187.19,1270684.68
Dec,Cash,0,635342.34,635342.34
Jan,Cheque,220608.44,0,855950.78
Feb,Miscellaneous,0,95105.64,760845.14
Mar,Bill,0,95105.64,665739.5
Apr,Reversal,0,95105.64,570633.86
May,Interest,0,95105.64,475528.22
Jun,Bill,0,475528.22,0
Jul,Commission,43,0,43
Aug,RTGS,0,4.78,38.22
Sep,Interest,6.06,0,44.28
Oct,Cheque,0,44.28,0
Nov,Interest,262.2,0,262.2
Dec,Miscellaneous,0,29.13,233.07
Jan,Transfer,0,46.61,186.46
Feb,IMPS,0,26.64,159.82
Mar,Bill,0,26.64,133.18
Apr,Interest,0,26.64,106.54
May,ATM,328,0,434.54
Jun,Cheque,368,0,802.54
Jul,ATM,1.25,0,803.79
Aug,NEFT,0,401.9,401.9
Sep,Tax,0,200.95,200.95
Oct,Cash,183430.3,0,183631.25
Nov,Purchase,0,18363.13,165268.12
Dec,Interest,1186767.75,0,1352035.87
Jan,Purchase,0,135203.59,1216832.28
Feb,ATM,244629,0,1461461.28
Mar,NEFT,131989.88,0,1593451.16
Apr,Cheque,0,318690.23,1274760.93
May,RTGS,50.29,0,1274811.22
Jun,Commission,18995,0,1293806.22
Jul,Cash,23.2,0,1293829.42
Aug,ATM,24555,0,1318384.42
Sep,Transfer,0,263676.88,1054707.54
Oct,Debit Card,0,131838.44,922869.1
Nov,Purchase,38.09,0,922907.19
Dec,Interest,0,307635.73,615271.46
Jan,NEFT,0,87895.92,527375.54
Feb,Tax,0,52737.55,474637.99
Mar,Purchase,0,67805.43,406832.56
Apr,ATM,0,40683.26,366149.3
May,ATM,10,0,366159.3
Jun,Bill,0,91539.83,274619.47
Jul,Miscellaneous,371.04,0,274990.51
Aug,Commission,2096142.75,0,2371133.26
Sep,NEFT,920236,0,3291369.26
Oct,RTGS,0,548561.54,2742807.72
Nov,RTGS,0,391829.67,2350978.05
Dec,Reversal,132108,0,2483086.05
Jan,Reversal,913.51,0,2483999.56
Feb,Tax,316.11,0,2484315.67
Mar,Purchase,222.8,0,2484538.47
Apr,NEFT,19797.3,0,2504335.77
May,Reversal,0,250433.58,2253902.19
Jun,Miscellaneous,377.5,0,2254279.69
Jul,Commission,598172,0,2852451.69
Aug,Reversal,5.8,0,2852457.49
Sep,Transfer,5146,0,2857603.49
Oct,Interest,0,285760.35,2571843.14
Nov,Bill,17018.1,0,2588861.24
Dec,ATM,3716.4,0,2592577.64
Jan,Tax,1.9,0,2592579.54
Feb,Transfer,8641,0,2601220.54
Mar,Purchase,0,289024.5,2312196.04
Apr,Reversal,0,578049.01,1734147.03
May,Transfer,0,247735.29,1486411.74
Jun,IMPS,0,247735.29,1238676.45
Jul,Reversal,0,1238676.45,0
Aug,Transfer,3487.69,0,3487.69
Sep,Interest,6,0,3493.69
Oct,Commission,77378.78,0,80872.47
Nov,Transfer,28993,0,109865.47
Dec,Miscellaneous,1405.7,0,111271.17
Jan,Cash,3316.6,0,114587.77
Feb,NEFT,215583.2,0,330170.97
Mar,Debit Card,7578,0,337748.97
Apr,IMPS,102916.84,0,440665.81
May,Cheque,0,440665.81,0
Jun,Miscellaneous,1.75,0,1.75
Jul,Bill,0,0.18,1.58
Aug,NEFT,456.6,0,458.18
Sep,Reversal,0,57.27,400.91
Oct,Tax,1263263.2,0,1263664.11
Nov,Purchase,2846.08,0,1266510.19
Dec,Cheque,0,211085.03,1055425.16
Jan,NEFT,0,105542.52,949882.64
Feb,Miscellaneous,0,135697.52,814185.12
Mar,Debit Card,248.84,0,814433.96
Apr,Cash,14696,0,829129.96
May,Bill,252094.69,0,1081224.65
Jun,Reversal,0,540612.33,540612.32
Jul,IMPS,6689.48,0,547301.8
Aug,Cash,0,109460.36,437841.44
Sep,Reversal,2699.09,0,440540.53
Oct,Reversal,141017,0,581557.53
Nov,RTGS,0,193852.51,387705.02
Dec,Debit Card,0,48463.13,339241.89
Jan,Commission,0,113080.63,226161.26
Feb,IMPS,0,113080.63,113080.63
Mar,NEFT,1682197,0,1795277.63
Apr,Purchase,0,448819.41,1346458.22
May,Commission,0,269291.64,1077166.58
Jun,Reversal,490.17,0,1077656.75
Jul,Miscellaneous,0,134707.09,942949.66
Aug,RTGS,0,134707.09,808242.57
Sep,Cheque,957601.5,0,1765844.07
Oct,Transfer,0,882922.04,882922.04
Nov,Debit Card,1639499,0,2522421.04
Dec,IMPS,0,280269,2242152.04
Jan,NEFT,7.7,0,2242159.74
Feb,RTGS,0,560539.94,1681619.81
Mar,Miscellaneous,209.7,0,1681829.51
Apr,Bill,210,0,1682039.51
May,Debit Card,0,168203.95,1513835.56
Jun,Reversal,64711,0,1578546.56
Jul,Transfer,0,225506.65,1353039.91
Aug,Purchase,47.4,0,1353087.31
Sep,Tax,0,1353087.31,0
Oct,ATM,16,0,16
Nov,NEFT,549452,0,549468
Dec,Debit Card,2011,0,551479
Jan,Cheque,36265.7,0,587744.7
Feb,IMPS,0,73468.09,514276.61
Mar,NEFT,0,128569.15,385707.46
Apr,NEFT,1,0,385708.46
May,Interest,208209,0,593917.46
Jun,ATM,1353056,0,1946973.46
Jul,Reversal,211192.2,0,2158165.66
Aug,Commission,1208861.75,0,3367027.41
Sep,Debit Card,0,420878.43,2946148.98
Oct,Reversal,0,2946148.98,0
Nov,Purchase,44.18,0,44.18
Dec,Cheque,25.59,0,69.77
Jan,NEFT,36.78,0,106.55
Feb,Bill,167784.8,0,167891.35
Mar,Transfer,0,41972.84,125918.51
Apr,Purchase,39.4,0,125957.91
May,Miscellaneous,1783801.5,0,1909759.41
Jun,Cash,15493,0,1925252.41
Jul,Bill,264739,0,2189991.41
Aug,Cash,19.02,0,2190010.43
Sep,Purchase,0,219001.04,1971009.39
Oct,Commission,0,281572.77,1689436.62
Nov,Cheque,0,187715.18,1501721.44
Dec,Interest,52,0,1501773.44
Jan,NEFT,0,250295.57,1251477.87
Feb,Miscellaneous,44.4,0,1251522.27
Mar,Tax,41595.12,0,1293117.39
Apr,NEFT,0,143679.71,1149437.68
May,Reversal,0,127715.3,1021722.38
Jun,Purchase,468626.2,0,1490348.58
Jul,Miscellaneous,0,372587.15,1117761.44
Aug,Commission,0,159680.21,958081.23
Sep,Cheque,0,191616.25,766464.98
Oct,Reversal,121.12,0,766586.1
Nov,Cheque,0,127764.35,638821.75
Dec,Interest,0,638821.75,0
Jan,Transfer,3.16,0,3.16
Feb,Interest,703480,0,703483.16
Mar,RTGS,1711,0,705194.16
Apr,Purchase,0,100742.02,604452.14
May,Interest,1.32,0,604453.46
Jun,Tax,0,201484.49,402968.97
Jul,IMPS,0,80593.79,322375.18
Aug,NEFT,6.58,0,322381.76
Sep,Reversal,54.2,0,322435.96
Oct,Tax,195550.25,0,517986.21
Nov,Transfer,0,73998.03,443988.18
Dec,Miscellaneous,0,443988.18,0
Jan,Commission,24301.27,0,24301.27
Feb,NEFT,91448.16,0,115749.43
Mar,Cash,0,115749.43,0
Apr,Cash,3230.22,0,3230.22
May,Bill,1793036.5,0,1796266.72
Jun,Tax,28953.07,0,1825219.79
Jul,Reversal,0,182521.98,1642697.81
Aug,IMPS,0,182521.98,1460175.83
Sep,Cheque,202.5,0,1460378.33
Oct,Tax,0,208625.48,1251752.85
Nov,IMPS,441.73,0,1252194.58
Dec,Cheque,202678.6,0,1454873.18
Jan,Bill,0,484957.73,969915.45
Feb,Purchase,0,242478.86,727436.59
Mar,Miscellaneous,17679.9,0,745116.49
Apr,Debit Card,1106759.8,0,1851876.29
May,RTGS,0,264553.76,1587322.53
Jun,NEFT,128369.7,0,1715692.23
Jul,Purchase,0,214461.53,1501230.7
Aug,RTGS,0,166803.41,1334427.29
Sep,Purchase,0,444809.1,889618.19
Oct,ATM,0,222404.55,667213.64
Nov,Debit Card,405.84,0,667619.48
Dec,Debit Card,0,74179.94,593439.54
Jan,Cash,3576.3,0,597015.84
Feb,Purchase,0,199005.28,398010.56
Mar,Purchase,0,49751.32,348259.24
Apr,Reversal,1404,0,349663.24
May,IMPS,12,0,349675.24
Jun,Reversal,2194,0,351869.24
Jul,Tax,0,87967.31,263901.93
Aug,Cash,0,37700.28,226201.65
Sep,Cash,0,25133.52,201068.13
Oct,Cash,0,25133.52,175934.61
Nov,ATM,0,87967.31,87967.3
Dec,Transfer,52.9,0,88020.2
Jan,ATM,0,22005.05,66015.15
Feb,Reversal,3500.43,0,69515.58
Mar,Cheque,0,23171.86,46343.72
Apr,Debit Card,124,0,46467.72
May,NEFT,614.9,0,47082.62
Jun,Reversal,2077951,0,2125033.62
Jul,Interest,17966,0,2142999.62
Aug,Interest,0,1071499.81,1071499.81
Sep,Purchase,30587,0,1102086.81
Oct,Cheque,0,275521.7,826565.11
Nov,Transfer,0,137760.85,688804.26
Dec,Reversal,46687.75,0,735492.01
Jan,Transfer,0,147098.4,588393.61
Feb,NEFT,2,0,588395.61
Mar,Cash,1327039,0,1915434.61
Apr,ATM,81714,0,1997148.61
May,Transfer,7.96,0,1997156.57
Jun,IMPS,238.07,0,1997394.64
Jul,Purchase,0,285342.09,1712052.55
Aug,Cash,0,244578.94,1467473.61
Sep,Reversal,11869.68,0,1479343.29
Oct,ATM,32383,0,1511726.29
Nov,Commission,16169.83,0,1527896.12
Dec,Interest,364.6,0,1528260.72
Jan,RTGS,0,169806.75,1358453.97
Feb,Miscellaneous,1274.5,0,1359728.47
Mar,Commission,0,339932.12,1019796.35
Apr,Tax,0,339932.12,679864.23
May,Purchase,0,679864.23,0
Jun,RTGS,1,0,1
Jul,Commission,0,0.2,0.8
Aug,Cheque,0,0.09,0.71
Sep,ATM,0,0.36,0.36
Oct,ATM,0,0.12,0.24
Nov,IMPS,27.24,0,27.48
Dec,Miscellaneous,0,3.44,24.04
Jan,Tax,0,4.01,20.03
Feb,ATM,717975,0,717995.03
Mar,Bill,0,71799.5,646195.53
Apr,Transfer,0,92313.65,553881.88
May,Purchase,5,0,553886.88
Jun,Reversal,0,553886.88,0
Jul,Reversal,247212,0,247212
Aug,Commission,0,27468,219744
Sep,IMPS,0,36624,183120
Oct,Bill,0,61040,122080
Nov,Cash,239155,0,361235
Dec,Interest,0,180617.5,180617.5
Jan,Debit Card,253,0,180870.5
Feb,Transfer,207,0,181077.5
Mar,Cash,53.15,0,181130.65
Apr,Transfer,331,0,181461.65
May,Reversal,5.4,0,181467.05
Jun,Cash,308067,0,489534.05
Jul,Miscellaneous,0,122383.51,367150.54
Aug,Bill,0,52450.08,314700.46
Sep,Transfer,21928,0,336628.46
Oct,Bill,295,0,336923.46
Nov,Debit Card,0,112307.82,224615.64
Dec,RTGS,15352.1,0,239967.74
Jan,Reversal,1881433.5,0,2121401.24
Feb,NEFT,0,212140.12,1909261.12
Mar,Miscellaneous,28,0,1909289.12
Apr,ATM,0,238661.14,1670627.98
May,ATM,0,167062.8,1503565.18
Jun,NEFT,0,150356.52,1353208.66
Jul,Purchase,122,0,1353330.66
Aug,Purchase,804.02,0,1354134.68
Sep,Miscellaneous,15169.74,0,1369304.42
Oct,Cash,0,273860.88,1095443.54
Nov,Tax,0,121715.95,973727.59
Dec,Bill,0,324575.86,649151.73
Jan,NEFT,0,649151.73,0
Feb,Tax,0.6,0,0.6
Mar,IMPS,81,0,81.6
Apr,Tax,0,10.2,71.4
May,IMPS,0,7.93,63.47
Jun,Cheque,12,0,75.47
Jul,IMPS,0,18.87,56.6
Aug,Interest,0,18.87,37.73
Sep,Commission,0,7.55,30.18
Oct,Interest,0,3.02,27.16
Nov,Purchase,0,2.72,24.44
Dec,Tax,0,3.06,21.38
Jan,ATM,3265.05,0,3286.43
Feb,Reversal,246.9,0,3533.33
Mar,Bill,2050597,0,2054130.33
Apr,Cheque,0,205413.03,1848717.3
May,Tax,0,369743.46,1478973.84
Jun,Interest,4.9,0,1478978.74
Jul,IMPS,52.9,0,1479031.64
Aug,Purchase,0,739515.82,739515.82
Sep,Debit Card,0,246505.27,493010.55
Oct,Purchase,4928.5,0,497939.05
Nov,IMPS,0,497939.05,0
Dec,NEFT,79.8,0,79.8
Jan,Debit Card,2966.7,0,3046.5
Feb,Transfer,0,507.75,2538.75
Mar,IMPS,115085,0,117623.75
Apr,Bill,510241.8,0,627865.55
May,Miscellaneous,266.9,0,628132.45
Jun,NEFT,0,209377.48,418754.97
Jul,Tax,2083601,0,2502355.97
Aug,ATM,0,417059.33,2085296.64
Sep,Purchase,0.6,0,2085297.24
Oct,NEFT,0,695099.08,1390198.16
Nov,Cheque,32669,0,1422867.16
Dec,ATM,0,284573.43,1138293.73
Jan,Tax,0,1138293.73,0
Feb,Cash,3665,0,3665
Mar,Reversal,1527111,0,1530776
Apr,Transfer,1.3,0,1530777.3
May,Bill,0,218682.47,1312094.83
Jun,Purchase,400,0,1312494.83
Jul,Tax,3764.41,0,1316259.24
Aug,NEFT,0,329064.81,987194.43
Sep,Purchase,0,197438.89,789755.54
Oct,IMPS,1561235.2,0,2350990.74
Nov,Tax,66751.6,0,2417742.34
Dec,Cheque,0,483548.47,1934193.87
Jan,ATM,48.5,0,1934242.37
Feb,Miscellaneous,0,967121.19,967121.18
Mar,NEFT,1831112,0,2798233.18
Apr,Interest,202,0,2798435.18
May,ATM,462.3,0,2798897.48
Jun,Cheque,0,466482.91,2332414.57
Jul,Commission,55.42,0,2332469.99
Aug,Transfer,219676.84,0,2552146.83
Sep,Purchase,0,2552146.83,0
Oct,Miscellaneous,214631.5,0,214631.5
Nov,RTGS,0,26828.94,187802.56
Dec,Reversal,0,26828.94,160973.62
Jan,IMPS,0,26828.94,134144.68
Feb,Bill,0,44714.89,89429.79
Mar,Cash,429.46,0,89859.25
Apr,Interest,0,29953.08,59906.17
May,Cheque,0,14976.54,44929.63
Jun,IMPS,24,0,44953.63
Jul,Reversal,0,5619.2,39334.43
Aug,ATM,176728,0,216062.43
Sep,Cheque,406,0,216468.43
Oct,NEFT,3086.1,0,219554.53
Nov,Reversal,0,27444.32,192110.21
Dec,IMPS,202046,0,394156.21
Jan,IMPS,402,0,394558.21
Feb,Miscellaneous,0,49319.78,345238.43
Mar,Purchase,749482,0,1094720.43
Apr,RTGS,0,136840.05,957880.38
May,Tax,15411.18,0,973291.56
Jun,Tax,0,139041.65,834249.91
Jul,Commission,56.83,0,834306.74
Aug,NEFT,0,119186.68,715120.06
Sep,Cash,183560.8,0,898680.86
Oct,Transfer,32541.7,0,931222.56
Nov,Tax,250272,0,1181494.56
Dec,Tax,3597.6,0,1185092.16
Jan,Tax,0,197515.36,987576.8
Feb,Purchase,0,123447.1,864129.7
Mar,Transfer,393.2,0,864522.9
Apr,Debit Card,0,144087.15,720435.75
May,IMPS,5.63,0,720441.38
Jun,Transfer,1215956,0,1936397.38
Jul,Interest,0,1936397.38,0
Aug,Debit Card,14.53,0,14.53
Sep,Miscellaneous,0,7.27,7.26
Oct,Cheque,1089.5,0,1096.76
Nov,Bill,0,109.68,987.08
Dec,Commission,494148.8,0,495135.88
Jan,Bill,0,70733.7,424402.18
Feb,Tax,0,212201.09,212201.09
Mar,RTGS,1.42,0,212202.51
Apr,IMPS,131,0,212333.51
May,IMPS,485,0,212818.51
Jun,Purchase,0,35469.75,177348.76
Jul,Transfer,7204,0,184552.76
Aug,RTGS,0,23069.1,161483.66
Sep,Commission,2647,0,164130.66
Oct,Commission,16105,0,180235.66
Nov,Miscellaneous,0.47,0,180236.13
Dec,Transfer,0,25748.02,154488.11
Jan,IMPS,136644,0,291132.11
Feb,RTGS,0,291132.11,0
Mar,Interest,5.02,0,5.02
Apr,Cash,17649.3,0,17654.32
May,Miscellaneous,95902.5,0,113556.82
Jun,Interest,1761286.2,0,1874843.02
Jul,ATM,0,468710.76,1406132.26
Aug,ATM,104780.47,0,1510912.73
Sep,RTGS,1880761.5,0,3391674.23
Oct,Interest,0,565279.04,2826395.19
Nov,Interest,0,565279.04,2261116.15
Dec,Cash,249,0,2261365.15
Jan,Debit Card,0,452273.03,1809092.12
Feb,Reversal,4,0,1809096.12
Mar,Reversal,227229.75,0,2036325.87
Apr,Debit Card,2718,0,2039043.87
May,Cash,0,509760.97,1529282.9
Jun,RTGS,264847,0,1794129.9
Jul,Transfer,139.16,0,1794269.06
Aug,ATM,91.52,0,1794360.58
Sep,Reversal,0,224295.07,1570065.51
Oct,Miscellaneous,535378,0,2105443.51
Nov,Tax,230588.5,0,2336032.01
Dec,Cash,7.2,0,2336039.21
Jan,NEFT,0,778679.74,1557359.47
Feb,Reversal,0,155735.95,1401623.52
Mar,Transfer,0,155735.95,1245887.57
Apr,Cheque,0,124588.76,1121298.81
May,Interest,3988.81,0,1125287.62
Jun,Reversal,0,125031.96,1000255.66
Jul,Purchase,3163,0,1003418.66
Aug,Tax,1722358,0,2725776.66
Sep,IMPS,0,681444.17,2044332.5
Oct,Bill,0,340722.08,1703610.42
Nov,IMPS,0,567870.14,1135740.28
Dec,NEFT,3071.2,0,1138811.48
Jan,Tax,34.9,0,1138846.38
Feb,Reversal,0,227769.28,911077.1
Mar,Tax,0,303692.37,607384.73
Apr,Transfer,0,151846.18,455538.55
May,Debit Card,3131.03,0,458669.58
Jun,Cash,0,57333.7,401335.88
Jul,Interest,2883.4,0,404219.28
Aug,Purchase,6.5,0,404225.78
Sep,Commission,191,0,404416.78
Oct,IMPS,124769,0,529185.78
Nov,Tax,483.89,0,529669.67
Dec,Tax,0,66208.71,463460.96
Jan,Purchase,38,0,463498.96
Feb,RTGS,17640.61,0,481139.57
Mar,Cash,424,0,481563.57
Apr,Interest,27705.8,0,509269.37
May,Tax,0,127317.34,381952.03
Jun,Cheque,0,63658.67,318293.36
Jul,Debit Card,0,45470.48,272822.88
Aug,Debit Card,189.75,0,273012.63
Sep,Purchase,0,68253.16,204759.47
Oct,Cheque,4193.21,0,208952.68
Nov,Interest,0,52238.17,156714.51
Dec,Miscellaneous,0,0,156714.51
Jan,Commission,4.14,0,156718.65
Feb,Reversal,4.26,0,156722.91
Mar,Debit Card,521266,0,677988.91
Apr,ATM,0,67798.89,610190.02
May,IMPS,0,67798.89,542391.13
Jun,Interest,0,542391.13,0
Jul,ATM,218,0,218
Aug,Bill,0,0,218
Sep,NEFT,31021.23,0,31239.23
Oct,Cheque,155942.78,0,187182.01
Nov,Reversal,1172520,0,1359702.01
Dec,Reversal,266,0,1359968.01
Jan,Bill,450.1,0,1360418.11
Feb,IMPS,0,1360418.11,0
Mar,Commission,1.9,0,1.9
Apr,IMPS,0,0.38,1.52
May,Cheque,2,0,3.52
Jun,Debit Card,1,0,4.52
Jul,Commission,4.06,0,8.58
Aug,Cash,0,4.29,4.29
Sep,Debit Card,0,0.48,3.81
Oct,Miscellaneous,0,1.27,2.54
Nov,Purchase,0,0.64,1.9
Dec,Transfer,504.78,0,506.68
Jan,Interest,0,168.89,337.79
Feb,Bill,0,42.22,295.57
Mar,Tax,0,98.52,197.05
Apr,NEFT,26,0,223.05
May,Reversal,0,111.53,111.52
Jun,Reversal,25703.58,0,25815.1
Jul,Commission,0,4302.52,21512.58
Aug,Commission,0,2390.29,19122.29
Sep,Reversal,0,19122.29,0
Oct,Bill,1243,0,1243
Nov,Purchase,0,414.33,828.67
Dec,IMPS,0,82.87,745.8
Jan,ATM,0,124.3,621.5
Feb,Tax,13.22,0,634.72
Mar,ATM,32293,0,32927.72
Apr,Debit Card,2,0,32929.72
May,RTGS,565,0,33494.72
Jun,ATM,103.2,0,33597.92
Jul,RTGS,434.5,0,34032.42
Aug,Purchase,316.48,0,34348.9
Sep,Bill,0,3434.89,30914.01
Oct,ATM,0,10304.67,20609.34
Nov,Bill,26729.7,0,47339.04
Dec,Purchase,6,0,47345.04
Jan,Tax,0,5918.13,41426.91
Feb,Miscellaneous,0,13808.97,27617.94
Mar,Cheque,0,3452.24,24165.7
Apr,Debit Card,0,3020.71,21144.99
May,Reversal,195770.94,0,216915.93
Jun,Purchase,0,216915.93,0
Jul,Cheque,40.5,0,40.5
Aug,Miscellaneous,1433.3,0,1473.8
Sep,Commission,0,736.9,736.9
Oct,RTGS,0,122.82,614.08
Nov,Cheque,1798,0,2412.08
Dec,Tax,0,301.51,2110.57
Jan,Cheque,0,703.52,1407.05
Feb,Transfer,43.53,0,1450.58
Mar,Cheque,118.02,0,1568.6
Apr,Purchase,0,156.86,1411.74
May,Tax,2.01,0,1413.75
Jun,Interest,0,141.38,1272.38
Jul,IMPS,3.9,0,1276.28
Aug,Reversal,0,319.07,957.21
Sep,Purchase,0,239.3,717.91
Oct,Debit Card,25537,0,26254.91
Nov,Cheque,5.21,0,26260.12
Dec,Bill,0,2626.01,23634.11
Jan,Cheque,1888,0,25522.11
Feb,Miscellaneous,0,5104.42,20417.69
Mar,NEFT,5,0,20422.69
Apr,Interest,1675.4,0,22098.09
May,Interest,0,2455.34,19642.75
Jun,Commission,0,19642.75,0
Jul,Miscellaneous,393283,0,393283
Aug,Reversal,0,39328.3,353954.7
Sep,NEFT,0,88488.68,265466.03
Oct,Bill,132441.5,0,397907.53
Nov,ATM,0,56843.93,341063.6
Dec,Bill,2,0,341065.6
Jan,Purchase,0.78,0,341066.38
Feb,Cheque,4.68,0,341071.06
Mar,Reversal,0,85267.77,255803.3
Apr,ATM,2816,0,258619.3
May,Tax,0,28735.48,229883.82
Jun,NEFT,0,28735.48,201148.34
Jul,Miscellaneous,0,20114.83,181033.51
Aug,Miscellaneous,89,0,181122.51
Sep,Reversal,1139909.5,0,1321032.01
Oct,ATM,0,220172,1100860.01
Nov,ATM,1000.73,0,1101860.74
Dec,Tax,150.16,0,1102010.9
Jan,Reversal,0,110201.09,991809.81
Feb,Cheque,0.75,0,991810.56
Mar,RTGS,0,123976.32,867834.24
Apr,RTGS,0,867834.24,0
May,ATM,470.8,0,470.8
Jun,Reversal,0,78.47,392.33
Jul,RTGS,708.45,0,1100.78
Aug,Commission,0,1100.78,0
Sep,Reversal,299,0,299
Oct,Cheque,0,42.71,256.29
Nov,Transfer,409.92,0,666.21
Dec,NEFT,0,95.17,571.04
Jan,Reversal,0,190.35,380.69
Feb,Reversal,7795.52,0,8176.21
Mar,Bill,0,4088.11,4088.1
Apr,Cheque,0,584.01,3504.09
May,Interest,1724460.5,0,1727964.59
Jun,Commission,0,215995.57,1511969.02
Jul,Transfer,0,1511969.02,0
Aug,Purchase,77372.22,0,77372.22
Sep,Reversal,0,11053.17,66319.05
Oct,ATM,0,8289.88,58029.17
Nov,Bill,11943.3,0,69972.47
Dec,Purchase,0,8746.56,61225.91
Jan,Transfer,0,61225.91,0
Feb,Reversal,8,0,8
Mar,ATM,0,1.33,6.67
Apr,Reversal,0,1.33,5.34
May,Cheque,0,0.76,4.58
Jun,IMPS,1.5,0,6.08
Jul,Transfer,0,0.76,5.32
Aug,Debit Card,0,0.89,4.43
Sep,NEFT,434.96,0,439.39
Oct,IMPS,160566,0,161005.39
Nov,Bill,25598,0,186603.39
Dec,Miscellaneous,0,26657.63,159945.76
Jan,Reversal,0,159945.76,0
Feb,Tax,1.64,0,1.64
Mar,ATM,0,0.41,1.23
Apr,RTGS,0,0.41,0.82
May,RTGS,0,0.14,0.68
Jun,IMPS,0,0.17,0.51
Jul,Cash,0,0.1,0.41
Aug,Reversal,0,0.41,0
Sep,Commission,413.92,0,413.92
Oct,Debit Card,0,68.99,344.93
Nov,ATM,0,86.23,258.7
Dec,Transfer,0,43.12,215.58
Jan,Commission,1820804.5,0,1821020.08
Feb,IMPS,0,227627.51,1593392.57
Mar,Debit Card,0,318678.51,1274714.06
Apr,Interest,6.09,0,1274720.15
May,Bill,0.8,0,1274720.95
Jun,Commission,0,637360.48,637360.48
Jul,Cheque,1340.83,0,638701.31
Aug,Tax,1162.5,0,639863.81
Sep,Tax,4.35,0,639868.16
Oct,Transfer,0,159967.04,479901.12
Nov,RTGS,0,47990.11,431911.01
Dec,NEFT,0,143970.34,287940.67
Jan,IMPS,0,57588.13,230352.54
Feb,Transfer,0,57588.14,172764.4
Mar,ATM,0,86382.2,86382.2
Apr,Tax,1733,0,88115.2
May,Tax,0,11014.4,77100.8
Jun,IMPS,56329,0,133429.8
Jul,Cash,84173.2,0,217603
Aug,Cheque,495.26,0,218098.26
Sep,IMPS,0,36349.71,181748.55
Oct,NEFT,18284,0,200032.55
Nov,Cheque,25762.3,0,225794.85
Dec,NEFT,0,56448.71,169346.14
Jan,Commission,387.69,0,169733.83
Feb,RTGS,0,42433.46,127300.37
Mar,NEFT,0,42433.46,84866.91
Apr,ATM,0,16973.38,67893.53
May,Debit Card,0,13578.71,54314.82
Jun,Cash,0,7759.26,46555.56
Jul,Tax,148537.4,0,195092.96
Aug,NEFT,158135.8,0,353228.76
Sep,ATM,2,0,353230.76
Oct,Miscellaneous,41042.53,0,394273.29
Nov,IMPS,6,0,394279.29
Dec,Miscellaneous,0,98569.82,295709.47
Jan,Purchase,130.7,0,295840.17
Feb,Bill,0,49306.7,246533.47
Mar,Transfer,5680.1,0,252213.57
Apr,Cash,0,252213.57,0
May,NEFT,148786.5,0,148786.5
Jun,IMPS,77935.3,0,226721.8
Jul,Purchase,58,0,226779.8
Aug,Commission,0,56694.95,170084.85
Sep,RTGS,4.5,0,170089.35
Oct,Cheque,0,24298.48,145790.87
Nov,Purchase,0,14579.09,131211.78
Dec,Reversal,0,16401.47,114810.31
Jan,Interest,2,0,114812.31
Feb,Interest,0,16401.76,98410.55
Mar,Commission,506.6,0,98917.15
Apr,Purchase,1,0,98918.15
May,Cash,0,98918.15,0
Jun,Cash,11066.1,0,11066.1
Jul,Commission,0,2766.53,8299.58
Aug,Debit Card,32436,0,40735.58
Sep,RTGS,86316,0,127051.58
Oct,NEFT,92312.8,0,219364.38
Nov,NEFT,0,219364.38,0
Dec,Debit Card,1041187.8,0,1041187.8
Jan,Interest,198063.2,0,1239251
Feb,Cash,0,247850.2,991400.8
Mar,Bill,0,141628.69,849772.11
Apr,Tax,0,212443.03,637329.08
May,Bill,0,79666.14,557662.94
Jun,IMPS,404.3,0,558067.24
Jul,RTGS,47,0,558114.24
Aug,Reversal,53,0,558167.24
Sep,IMPS,221202,0,779369.24
Oct,NEFT,0,86596.58,692772.66
Nov,ATM,0,346386.33,346386.33
Dec,RTGS,25380.4,0,371766.73
Jan,Tax,0,92941.68,278825.05
Feb,Interest,0,46470.84,232354.21
Mar,ATM,0,77451.4,154902.81
Apr,NEFT,0,25817.14,129085.68
May,NEFT,214596.7,0,343682.38
Jun,ATM,8,0,343690.38
Jul,Commission,7.36,0,343697.74
Aug,Tax,101.2,0,343798.94
Sep,ATM,765024.5,0,1108823.44
Oct,IMPS,0,158403.35,950420.09
Nov,Cash,3846.05,0,954266.14
Dec,Debit Card,8514.84,0,962780.98
Jan,Interest,0,192556.2,770224.78
Feb,Commission,0,256741.59,513483.19
Mar,Cheque,6.6,0,513489.79
Apr,Bill,32445,0,545934.79
May,NEFT,0,545934.79,0
Jun,Cash,279902.2,0,279902.2
Jul,ATM,0,46650.37,233251.83
Aug,IMPS,0,23325.18,209926.65
Sep,IMPS,2456,0,212382.65
Oct,Reversal,0,35397.11,176985.54
Nov,Reversal,0,58995.18,117990.36
Dec,Transfer,2974.97,0,120965.33
Jan,Reversal,0.4,0,120965.73
Feb,IMPS,0,30241.43,90724.3
Mar,NEFT,0,90724.3,0
Apr,NEFT,30745,0,30745
May,Reversal,39.48,0,30784.48
Jun,Purchase,45,0,30829.48
Jul,NEFT,2477,0,33306.48
Aug,Tax,0,11102.16,22204.32
Sep,Bill,6855.54,0,29059.86
Oct,Commission,99498.25,0,128558.11
Nov,Debit Card,2408.7,0,130966.81
Dec,RTGS,0,21827.8,109139.01
Jan,IMPS,0,10913.9,98225.11
Feb,Debit Card,0,98225.11,0
Mar,Interest,213612.9,0,213612.9
Apr,Interest,295.19,0,213908.09
May,Miscellaneous,40.63,0,213948.72
Jun,Reversal,10,0,213958.72
Jul,Miscellaneous,2117,0,216075.72
Aug,Purchase,0,43215.14,172860.58
Sep,Cheque,0,43215.15,129645.44
Oct,ATM,0,64822.72,64822.72
Nov,Tax,7,0,64829.72
Dec,Bill,5.7,0,64835.42
Jan,Miscellaneous,1433102,0,1497937.42
Feb,Tax,1783,0,1499720.42
Mar,Reversal,0,249953.4,1249767.02
Apr,Bill,44.4,0,1249811.42
May,Tax,0,178544.49,1071266.93
Jun,Bill,1585369,0,2656635.93
Jul,Debit Card,0,2656635.93,0
Aug,Miscellaneous,175.1,0,175.1
Sep,Interest,0,17.51,157.59
Oct,Bill,44,0,201.59
Nov,IMPS,0,33.6,167.99
Dec,Miscellaneous,1735.7,0,1903.69
Jan,Commission,21,0,1924.69
Feb,IMPS,7,0,1931.69
Mar,Debit Card,0,193.17,1738.52
Apr,Bill,41897.59,0,43636.11
May,Interest,2.57,0,43638.68
Jun,RTGS,0,10909.67,32729.01
Jul,ATM,0,4091.13,28637.88
Aug,Transfer,6,0,28643.88
Sep,Purchase,0,4091.98,24551.9
Oct,Interest,21275,0,45826.9
Nov,Transfer,0,11456.73,34370.18
Dec,Commission,0,4910.03,29460.15
Jan,Bill,0,3273.35,26186.8
Feb,Debit Card,3.6,0,26190.4
Mar,IMPS,2488.89,0,28679.29
Apr,Bill,214.2,0,28893.49
May,NEFT,0,4815.58,24077.91
Jun,RTGS,0,3009.74,21068.17
Jul,Cash,1188,0,22256.17
Aug,Commission,2.34,0,22258.51
Sep,NEFT,494.3,0,22752.81
Oct,Commission,0,22752.81,0
Nov,Miscellaneous,352.73,0,352.73
Dec,Interest,0,88.18,264.55
Jan,Cash,0,33.07,231.48
Feb,ATM,1787505.25,0,1787736.73
Mar,ATM,676.7,0,1788413.43
Apr,IMPS,4071.06,0,1792484.49
May,Miscellaneous,440892,0,2233376.49
Jun,Transfer,916724.2,0,3150100.69
Jul,Bill,250246.75,0,3400347.44
Aug,Bill,10254.2,0,3410601.64
Sep,Reversal,0,426325.21,2984276.44
Oct,ATM,2.9,0,2984279.34
Nov,Cash,0,1492139.67,1492139.67
Dec,ATM,656229,0,2148368.67
Jan,Miscellaneous,0,429673.73,1718694.94
Feb,IMPS,0,429673.74,1289021.2
Mar,Transfer,36.65,0,1289057.85
Apr,Commission,7.9,0,1289065.75
May,Bill,0,143229.53,1145836.22
Jun,Tax,0,229167.24,916668.98
Jul,RTGS,0,229167.25,687501.74
Aug,Bill,2220.67,0,689722.41
Sep,Transfer,215597.1,0,905319.51
Oct,Commission,0,113164.94,792154.57
Nov,Debit Card,0,79215.46,712939.11
Dec,Transfer,56.3,0,712995.41
Jan,Miscellaneous,0,89124.43,623870.98
Feb,ATM,0,77983.87,545887.11
Mar,Transfer,413,0,546300.11
Apr,Miscellaneous,0,91050.02,455250.09
May,Transfer,0,65035.73,390214.36
Jun,Bill,0,55744.91,334469.45
Jul,ATM,6.3,0,334475.75
Aug,IMPS,0,47782.25,286693.5
Sep,RTGS,161115.19,0,447808.69
Oct,Bill,0,74634.78,373173.91
Nov,Interest,1560323,0,1933496.91
Dec,Commission,113223,0,2046719.91
Jan,Debit Card,0,341119.99,1705599.92
Feb,ATM,105458,0,1811057.92
Mar,Interest,496.94,0,1811554.86
Apr,Transfer,4,0,1811558.86
May,Reversal,2226.97,0,1813785.83
Jun,Transfer,0,181378.58,1632407.25
Jul,Miscellaneous,23427,0,1655834.25
Aug,Debit Card,3.52,0,1655837.77
Sep,Reversal,194,0,1656031.77
Oct,ATM,0,207003.97,1449027.8
Nov,Cash,0,207003.97,1242023.83
Dec,RTGS,0,124202.38,1117821.45
Jan,NEFT,0,1117821.45,0
Feb,Tax,1056.9,0,1056.9
Mar,Reversal,0,176.15,880.75
Apr,Transfer,348.2,0,1228.95
May,Commission,122.9,0,1351.85
Jun,Tax,2343.9,0,3695.75
Jul,ATM,685946,0,689641.75
Aug,Bill,1250581.8,0,1940223.55
Sep,Transfer,0,215580.39,1724643.16
Oct,NEFT,1861755.25,0,3586398.41
Nov,Debit Card,11.56,0,3586409.97
Dec,Commission,0,717281.99,2869127.98
Jan,Reversal,0,573825.6,2295302.38
Feb,Interest,31582.97,0,2326885.35
Mar,Cash,0,387814.23,1939071.12
Apr,NEFT,0,387814.22,1551256.9
May,RTGS,1986097.5,0,3537354.4
Jun,RTGS,0,505336.34,3032018.06
Jul,Bill,0,3032018.06,0
Aug,ATM,851534.75,0,851534.75
Sep,ATM,24011.7,0,875546.45
Oct,Miscellaneous,21,0,875567.45
Nov,RTGS,784870,0,1660437.45
Dec,Reversal,0,237205.35,1423232.1
Jan,Purchase,0,237205.35,1186026.75
Feb,RTGS,0,197671.13,988355.62
Mar,Cash,0,164725.94,823629.68
Apr,Cheque,608149,0,1431778.68
May,IMPS,1731394.5,0,3163173.18
Jun,Reversal,1204,0,3164377.18
Jul,Cheque,3514.4,0,3167891.58
Aug,Reversal,0,395986.45,2771905.13
Sep,IMPS,5211.46,0,2777116.59
Oct,Bill,51,0,2777167.59
Nov,Reversal,1223367,0,4000534.59
Dec,Bill,53355.3,0,4053889.89
Jan,Commission,0,450432.21,3603457.68
Feb,RTGS,0,450432.21,3153025.47
Mar,IMPS,0,630605.09,2522420.38
Apr,Transfer,0,630605.1,1891815.28
May,Transfer,0,378363.06,1513452.22
Jun,IMPS,256386.41,0,1769838.63
Jul,Bill,336765,0,2106603.63
Aug,Debit Card,3.77,0,2106607.4
Sep,Bill,0,702202.47,1404404.93
Oct,Cheque,27777,0,1432181.93
Nov,NEFT,3423,0,1435604.93
Dec,NEFT,0,358901.23,1076703.7
Jan,ATM,0,179450.62,897253.08
Feb,Purchase,216807,0,1114060.08
Mar,RTGS,0,185676.68,928383.4
Apr,NEFT,0,132626.2,795757.2
May,Reversal,32,0,795789.2
Jun,Transfer,7.65,0,795796.85
Jul,Bill,30003,0,825799.85
Aug,Transfer,0,412899.93,412899.92
Sep,Tax,2052.31,0,414952.23
Oct,IMPS,0,103738.06,311214.17
Nov,Bill,1484.2,0,312698.37
Dec,Miscellaneous,0,44671.2,268027.17
Jan,Cheque,281.9,0,268309.07
Feb,Transfer,6,0,268315.07
Mar,Reversal,3536.9,0,271851.97
